Steffane	Laurent
Meridith	Georas
Adey	Murvyn
Melli	Elton
Tobye	Alvin
Elaina	Cortie
Addi	Hyman
Susann	Rayner
Ingaberg	Giusto
Robenia	Frederich
Hulda	Rufus
Verla	Florian
Farra	Fremont
Judie	Angelo
Deena	Nickolai
Selinda	Eugene
Odetta	Meyer
Janeczka	Bartholemy
Lianne	Fitz
Ellen	Franchot
Loreen	Ferguson
Carley	Alwyn
Jacquelynn	Jan
Cyndia	Rowland
Desirae	Hodge
Carolann	Stanton
Phylis	Padraig
Josephine	Jerri
Celka	Flynn
Cordelie	Trip
Shelley	Fabe
Shanta	Chrissie
Marguerite	Norman
Catina	Quint
Orelee	Kory
Patrica	Elliott
Elsi	Shae
Dotti	Galven
Stephenie	Raymund
Rayshell	Josiah
Vania	Sarge
Clemmie	Colby
Hedwiga	Corbie
Susana	Osgood
Arlinda	Walsh
Donica	Davie
Roshelle	Tad
Adrian	Erv
Audry	Gardie
Joann	Rollins
Heloise	Angus
Carrissa	Homerus
Nerta	Randy
Shirlene	Taylor
Viva	Neall
Lorene	Weylin
Marjorie	Jackie
Mirella	Aldo
Estele	Eldin
Mallorie	Tally
Edy	Hakeem
Roxana	Roman
Laurella	Mallory
Kelley	Darrell
Audrie	Barth
Joelynn	Kane
Brenna	Alf
Francene	Maddie
Edwina	Jermain
Shaina	Brant
Wallie	Asher
Aleda	Jaye
Jaine	Flint
Ophelia	Robb
Margi	Whit
Jordana	Cal
Jobi	Omar
Hedda	Archie
Siusan	Kareem
Kippie	Ronald
Juliet	Graehme
Madlen	Scarface
Nerta	Haze
Orelie	Bartolomeo
Chloette	Cort
Marianne	Daren
Caprice	Thoma
Josephine	Boigie
Blondie	Walsh
Julia	Thedrick
Doralynne	Ambrose
Kellen	Sonny
Idalina	Sergeant
Philipa	Nigel
Allegra	Morse
Cosette	Law
Polly	Templeton
Lynne	Emlen
Gloria	Lalo
Tommy	Cash
Dyane	Alexandr
Sharona	Isador
Odele	Peder
Jannel	Garrard
Ronica	Jedd
Sande	Virge
Kimmy	Hilton
Clarabelle	Riobard
Ilysa	Prince
Alexis	Emmery
Judy	Rocky
Carlyn	Thorsten
Maryl	Bendick
Cathee	Fidole
Hilliary	ErvIn
Heidie	Alix
Ashla	Ax
Pauli	Dudley
Ediva	Marsh
Amara	Farris
Wenda	Cross
Rosabelle	Mohandis
Goldie	Markos
Oriana	Tabbie
Cindy	Ilaire
Crysta	Tully
Lia	Arin
Debi	Judas
Gnni	Maxwell
Eleni	Haywood
Gussy	Dietrich
Gaylene	Paddie
Marni	Garrard
Willi	Silvain
Lula	Talbot
Florentia	Johny
Debee	Shay
Carlynn	Llywellyn
Sadella	Hew
Desdemona	Lem
Krissie	Rice
Quinn	Fabiano
Margy	Mal
Tonye	Virgie
Dix	Nikki
Stephenie	Artemus
Melita	Sampson
Cleo	Kenton
Davita	Colet
Concettina	Gibby
Roxy	Abbey
Merl	Tull
Cherri	Shepard
Vally	Gifford
Jeannine	Filmer
Daffie	Akim
Tracee	Milty
Cymbre	Saleem
Sylvia	Curran
Anestassia	Giacomo
Shelby	Nealy
Marcille	Lemar
Tybi	Maynord
Fidela	Sauveur
Abra	Hy
Glynda	Teddy
Ulrika	Urbano
Twyla	Shane
Katharyn	Gonzalo
Brittne	Chaim
Florella	Mikael
Clemmie	Toddie
Krissie	Guillermo
Britta	Shell
Loralie	Burg
Collie	Wilmar
Sofia	Dorie
Andi	Ezechiel
Jessica	Tamas
Lianne	Gabe
Joella	Cyrus
Dina	Joshia
Stephenie	Erv
Shaylynn	Alfons
Cindra	Nealon
Lily	Wolfgang
Kaile	Korey
Ali	Micheil
Collete	Wilt
Korney	Bat
Kat	Grady
Zandra	Berk
Maressa	Baryram
Gratia	Regan
Reggi	Markus
Jayme	Hadley
Cammie	Tirrell
Vyky	Marv
Annissa	Briano
Lois	Rickie
Willetta	Ashbey
Jobyna	Poul
Sam	Spense
Cesya	Innis
Natividad	Rhys
Rori	Keenan
Darell	Orville
Idalia	Dell
Dynah	Sherwynd
Hadria	Raoul
Anastassia	Harlin
Robinett	Kevon
Frederique	Homere
Harri	Tadeas
Nydia	Burlie
Deborah	Remington
Rhiamon	Bartlett
Ida	Stinky
De	Rad
Suki	Booth
Georgie	Harper
Clo	Cordell
Tess	Fred
Marcille	Emory
Liv	Killy
Rorie	Scotty
Lilli	Jared
Junia	Daryl
Shelba	Curcio
Lonni	Wilbur
Merilyn	Puff
Nona	Skippy
Mercedes	Vaclav
Cindy	Jarid
Morgana	Scottie
Zita	Randi
Jazmin	Alwyn
Jessika	Douglas
Amye	Barclay
Jackquelin	Seward
Millie	Sanderson
Kristen	Ebenezer
Kerry	Towney
Misty	Manfred
Lesly	Bartlett
Gina	Had
Sallie	Dudley
Cahra	Dalton
Poppy	Dom
Darby	Ivar
Aurie	Adolph
Mehetabel	Osbert
Vinny	Clywd
Marietta	Lemmy
Elwira	Reece
Carmelia	Elton
Sheelagh	Filmore
Vonni	Phil
Karol	Kingsley
Dniren	Carter
Jennifer	Svend
Tova	Jule
Carolin	Mayne
Charissa	Nat
Cathee	Ellary
Shanie	Randolph
Karena	Mayne
Mariette	Court
Petronia	Toiboid
Lauren	Shalom
Ardine	Vladamir
Marita	Irvine
Willabella	Kristofer
Marybeth	See
Ros	Shannon
Mireille	Beale
Emelyne	Adelbert
Cathyleen	Brnaby
Raye	Inigo
Doe	Wilek
Beatrice	Bent
Martina	Jude
Gui	Simone
Mersey	Urbain
Lyn	Erasmus
Allsun	Bondie
Shanda	Colan
Elsi	Hallsy
Fay	Gerhard
Veronike	Rickard
Arielle	Sylas
Jacquenette	Ignaz
Fernandina	Pepe
Sheela	Innis
Clarissa	Farrell
Merna	Emmery
Merola	Peterus
Lizzie	Bourke
Conchita	Gilles
Sherie	Ezekiel
Melosa	Baryram
Shaun	Godart
Cindelyn	Gilles
Rianon	Clayborne
Pammy	Nap
Marcille	Johnathan
Lenee	Yancey
Cayla	Jedd
Bobbette	Jeramie
Aridatha	Ellary
Ethel	Obadias
Jilleen	Brendis
Rita	Ewen
Beverie	Welbie
Josey	Brewer
Bridgette	Reynard
Cecilia	Boony
Aurea	Asher
Allyce	Parke
Lila	Trip
Allissa	Mortimer
Linnea	Shermie
Nomi	Garwood
Cassandre	Augy
Ramona	Ricky
Merl	Brendis
Juliette	Gilburt
Nancee	Eugenius
Guendolen	Davidson
Elisabet	Reider
Cassy	Carney
Anthiathia	Vic
Louisette	Bert
Elita	Cary
Brinna	Christy
Terri	Kenon
Aprilette	Huntley
Jobyna	Waverly
Katerina	Matthus
Minette	Erroll
Doralin	Anatol
Kassi	Nat
Melanie	Clive
Kari	Samson
Roseline	Gavan
Sella	Rudolf
Angel	Sanson
Alessandra	Duffie
Milly	Lionello
Isahella	Chrisse
Amabel	Jarrid
Orly	Cully
Miof Mela	Ronald
Katine	Lyman
Drusie	Burke
Tedi	Clayborn
Lavina	Godart
Cariotta	Rudiger
Eloise	Arnaldo
Leoline	Arley
Scarlet	Brady
Saba	Juan
Karlotte	Hammad
Windy	Waiter
Layney	Mano
Astrix	Say
Yalonda	Hansiain
Alikee	Chick
Aurora	Emmerich
Costanza	Harwell
Ofella	Brien
Genevra	Tanny
Demetria	Brian
Veronika	Benny
Dorothy	Nataniel
Madeleine	Arnaldo
Robinia	Arvie
Cybil	Lonnard
Mufi	Alexandre
Maisie	Morie
Sherrie	Emmett
Michaela	Jerri
Tera	Maurise
Melisande	Allen
Penelope	Wildon
Dion	Hans
Tanya	Alvy
Carmelia	Hurleigh
Ninnetta	Kenn
Cordelie	Mickie
Bendite	Antoine
Amabelle	Connie
Ingunna	Rodge
Katusha	Gabe
Lilias	Archibold
Ayn	Graehme
Maisie	Carlos
Bobinette	Mickey
Kellia	Tabby
Selinda	Charley
Kathi	Kippie
Adrianne	Jareb
Emalee	Ignacio
Jenelle	Roddy
Carmelina	Hubie
Josselyn	Herculie
Delly	Neddy
Gabbi	Daniel
Dredi	Robinet
Malissia	Hamil
Sandie	Hubie
Evvy	Otto
Melody	Shermy
Dona	Rollin
Korrie	Franky
Brande	Ali
Cherise	Ian
Carly	Delmor
Kaylee	Alejoa
Meade	Asa
Gretal	Jock
Chloe	Callean
Kendra	Court
Mariele	Saw
Deina	Thomas
Nadeen	Joachim
Codi	Mace
Sarina	Iver
Lilla	Alyosha
Pammi	Bjorn
Stephanie	Merwin
Briney	Barthel
Nicolina	Hort
Aubine	Stewart
Ami	Cornall
Shawn	Haze
Suzi	Fonzie
Kyla	Zacherie
Nixie	Dael
Josephine	Cletus
Nina	Kaine
Anitra	Paddy
Margaretha	Hobard
Ethyl	Oby
Guenna	Les
Camel	Constantino
Helen	Rab
Caril	Winthrop
Kerry	Fulton
Nannette	Hank
Jermaine	Norrie
Mona	Giselbert
Bari	Artemas
Minna	Goraud
Ardene	Mikol
Olenka	Mose
Dasha	Culley
Mabel	Heath
Lisha	Cullie
Hollie	Brendan
Lorine	Garth
Clarine	Rutter
Zahara	Eugene
Randi	Byron
Tobey	Tucky
Masha	Ozzie
Stephannie	King
Sean	Cyrus
Gus	Harbert
Aile	Austen
Guenevere	Udell
Dorine	Grange
Cherice	Luther
Carree	Alejoa
Oralle	Vassili
Martynne	Stirling
Lena	Chet
Nerte	Prentiss
Sisely	Avery
Clarey	Syman
Bev	Klaus
Anthiathia	Kerry
Sharline	Monroe
Honey	Kennedy
Sandie	Sylas
Kirstin	Richmound
Katrina	Nester
Junie	Carlos
Lisabeth	Nickie
Jonie	Timothy
Ameline	Basilio
Pearline	Fredrick
Gilberte	Cristobal
Jo Ann	Efren
Francesca	Roley
Therese	Rodd
Phil	Bradly
Anneliese	Ellery
Layla	Garner
Babbie	Adelbert
Sonnie	Minor
Kamillah	Rossy
Beryl	Richy
Celestia	Winfield
Marigold	Raviv
Mariejeanne	Gilles
Cordy	Frederick
Merrily	Ward
Justina	Obediah
Odilia	Land
Angeline	Yard
Emiline	Bastien
Glenna	Northrop
Shana	Jody
Lonee	Ches
Clementina	Elmer
Louisette	Denver
Livy	Townsend
Ardenia	Wolf
Ann-Marie	Hinze
Celene	Olag
Lora	Jory
Jannelle	Vittorio
Alla	Denys
Johnna	Francois
Genia	Ewen
Nicki	Renard
Juli	Aloin
Cinnamon	Rockey
Rebbecca	Artus
Sharl	Wynn
Berna	Hector
Gabi	Maddie
Tabbatha	Arnoldo
Almeda	Ronny
Darb	Garrott
Marj	Caddric
Roberta	Khalil
Rosalinde	Isaac
Adriana	Daven
Valaria	Finlay
Harmonia	Guthrie
Ebonee	Jethro
Prissie	Wally
Faith	Jacob
Ursola	Creigh
Oralee	Padget
Sonia	Leo
Row	Jamie
Annamaria	Kerwinn
Joey	Mozes
Dasie	Kimbell
Quintana	Dionisio
Crissy	Dani
Gale	Sherwin
Rochella	Angelico
Karen	Fonz
Auberta	Duke
Marcelle	Darb
Alfy	Jedidiah
Costanza	Salomone
Jordanna	Rickard
Sarina	Willey
Karolina	Alfred
Florenza	Alix
Herminia	Francisco
Lonni	Lion
Verina	Jaye
Dorine	Ernst
Arlie	Tabb
Jeniffer	Delano
Linea	Seward
Dulcie	Ransom
Fawn	Rustie
Beth	Valentine
Ryann	Hazlett
Vinni	Johnnie
Belita	Noll
Adan	Eustace
Katrina	Brendis
Fifi	Car
Giorgia	Shermy
Aura	Cly
Aurea	Janek
Luce	Rickie
Adelheid	Berkley
Bobbi	Jarred
Georgeta	Micah
Magdaia	Gardner
Agatha	Rene
Paulina	Pattin
Shauna	Julie
Leonora	Alvy
Susi	Jed
Blakeley	Westbrooke
Marietta	Aluin
Ulrike	Normie
Kylila	Markos
Inger	Donall
Maryrose	Krishna
Kalila	Shepard
Penny	Caddric
Gerty	Arman
Pamella	Dorie
Ninetta	Obadiah
Cornie	Martin
Allx	Geordie
Theodora	Gunner
Leoine	Flinn
Debbie	Glen
Ricky	Kelly
Lizzie	Trace
Iormina	Sigfried
Felicdad	Bjorn
Fayina	Leonid
Vallie	Derward
Kelcy	Kincaid
Vida	Daron
Kimmi	Hillel
Ammamaria	Hurley
Tiphanie	Sylas
Carley	Carmine
Adan	Chandler
Bidget	Othello
Daryl	Quintus
Dorian	Gregorio
Maggie	Archambault
Dari	Hilary
Alvera	Geno
Cathrine	Cyrus
Nisse	Jarad
Melesa	Darren
Kamilah	Haskell
Phaedra	Antonius
Cymbre	Brewer
Marlo	Bordy
Billi	Clayson
Ofella	Alwyn
Heida	Brew
Hilde	Ulrich
Hannis	Linc
Dianne	Sollie
Sybyl	Mord
Clemmy	Laurent
Joy	Alaric
Wynn	Marsh
Sabra	Galvin
Constantina	Sammy
Peggie	Sheppard
Alameda	Diego
Shel	Kent
Aurilia	William
Valentia	Dov
Konstance	Barnaby
Lavinie	Otes
Rosalyn	Camey
Geraldine	Rolph
Brittaney	Ario
Abbye	Vaughan
Antonie	Arlan
Randee	Artie
Ursula	Tomkin
Ryann	Shanan
Arleyne	Joshua
Sal	Gage
Abigael	Yardley
Gilbertine	Rad
Imelda	Bard
Gussie	Andreas
Kaye	Ruby
Natasha	Zacharias
Kathlin	Tirrell
Hedi	Erie
Nerte	Orbadiah
Fredra	Orin
Veda	Graig
Lindsey	Mikey
Ursa	Terrance
Devora	Friedrich
Heda	Julio
Tildy	Dew
Roxi	Norbert
Sibel	Lyle
Jilly	Denis
Irma	Ronald
Liz	Tadeo
Emma	Rafaello
Lenore	Alanson
Caye	Humbert
Pier	Frederic
Jeannette	Sherwood
Hana	Conrado
Therine	Kyle
Lynde	Brok
Michaeline	Davy
Shirley	Renard
Rubia	Benyamin
Delcina	Leif
Aloysia	Waverly
Annamarie	Waverly
Alia	Egan
Celestine	Sigfried
Lilllie	Anatollo
Brandea	Stanly
Nanine	Wylie
Karlotta	Darnall
Lilyan	Hurleigh
Esther	Boyd
Alicea	Tremain
Alayne	Simon
Anthia	Bron
Lilllie	Stanislaus
Kimberli	Briano
Helaina	Aleksandr
Gustie	Chadd
Jillie	Erl
Charmian	Worthy
Mab	Skip
Caril	Ripley
Fredelia	Rutledge
Lanny	Sutton
Esta	Hew
Hedwiga	Hollis
Betteann	Jerrome
Aggi	Amble
Patti	Nester
Jan	Frederigo
Tobey	Fremont
Sue	Nikolaos
Bathsheba	Lionel
Helaine	Sarge
Cayla	Ozzy
Heidi	Amery
Erda	Parsifal
Alida	Stanley
Edee	Bartolemo
Jacquenette	Lonnie
Phelia	Tuck
Annmaria	Jeth
Emmie	Germaine
Sidonia	Teodor
Kial	Isa
Tamera	Noel
Allie	Basile
Carolina	Huey
Gabriella	Wallace
Koralle	Orazio
Willette	Anson
Camille	Germayne
Cordey	Joshia
Nettie	Morse
Nikkie	Benjamin
Alvina	Broddy
Cloe	Mike
Leia	Ramsay
Eachelle	Javier
Tiffy	Egor
Janine	Kendricks
Beverley	Nils
Addy	Arron
Joya	Rancell
Blair	Daren
Bernice	Lamar
Jacquenette	Farley
Dorita	Devland
Aurelia	Sean
Cristi	Emmy
Celia	Davide
Eadie	Harbert
Wendye	Blaine
Val	Garik
Seana	Berti
Krystal	Tymothy
Erna	Claiborne
Wenonah	Jdavie
Kym	Monro
Fernanda	Ivan
Nerti	Adamo
Cathyleen	Ange
Carmon	Bone
Kaycee	Isadore
Charlene	Braden
Phyllida	Mar
Griselda	Reidar
Grazia	Iosep
Ezmeralda	Rutger
Denice	Fitz
Shalna	Ade
Whitney	Gabbie
Lana	Felice
Jacqui	Bobbie
Paige	Felic
Kristi	Jeddy
Veronika	Shelby
Ardisj	Wilmer
Karyl	Hamid
Shanda	Freeland
Kori	Chick
Bernadette	Remington
Brita	Baily
Othilie	Padgett
Camila	Burch
Franni	Timmy
Anetta	Trent
Norma	Maurise
Janis	Maddie
Kanya	Odell
Erda	Lyman
Jennie	Garrett
Rikki	Hakeem
Kathie	Corbett
Layne	Dino
Tammie	Alden
Willamina	Brand
Lona	Meryl
Debbi	Tait
Alison	Coleman
Marabel	Trstram
Lilia	Pascal
Ailey	Walsh
Shanda	Emmy
Rachelle	Dukie
Vyky	Britt
Eve	Tobiah
Grier	Rodrique
Tiffany	Torrin
Kori	Andrus
Celeste	Mattheus
Theda	Johnny
Jenilee	Leif
Karalynn	Isadore
Odilia	Thorin
Karil	Wyn
Petronilla	Payton
Louise	Ives
Abra	Jeromy
Jeannette	Decca
Kyla	Egbert
Lilyan	Thoma
Jane	Gran
Estele	Frasier
Erena	Alejoa
Klara	Errol
Merrielle	Archambault
Joleen	Hubie
Lilia	Fairlie
Wandis	Gauthier
Marika	Keane
Ronni	Troy
Kelila	Ozzie
Quintilla	Yuri
Rowe	Trevor
Kellie	Raimund
Wendeline	Wallace
Gloriane	Phillipe
Candis	Galvan
Gwenore	Vachel
Estel	Irvine
Kristi	Bartel
Aleece	Wainwright
Dyna	Cy
Otha	Cello
Coral	Roderigo
Bobina	Ronnie
Joleen	Gottfried
Maritsa	Thorpe
Goldia	Alistair
Wini	Randolph
Rebeca	Germayne
Sile	Stewart
Calida	Cory
Grata	Dev
Cheslie	Gregorio
Joanna	Urbanus
Amie	Percy
Janka	Lowrance
Corene	Mano
Hortensia	Enrico
Phyllys	Perry
Dniren	Terrell
Delphinia	Dewey
Ivory	Craggie
Mignon	Rolph
Glori	Arnuad
Xaviera	Olav
Ammamaria	Stanwood
Dee Dee	Bertram
Maryann	Burl
Aleda	Ragnar
Alameda	Vaughan
Ashien	Shane
Paule	Gallagher
Elianore	Niel
Alie	Gideon
Candide	Xavier
Babara	Fonsie
Kakalina	Jackson
Karin	Bartholemy
Klarrisa	Isa
Bunny	Dennis
Carmela	Dory
Winnifred	Jethro
Leslie	Mitchell
Gale	Nevil
Hinda	Port
Melinda	Ruddy
Donica	Denys
Janeva	Emory
Georgena	Geoff
Benedicta	Martainn
Cristal	Christopher
Ruthann	Tobie
Kizzie	Owen
Bari	Nevil
Alli	Ray
Devon	Obie
Grissel	Perkin
Elfreda	Heindrick
Lydie	Richy
Doro	Julian
Bari	Jon
Mareah	Hamish
Olimpia	Jarret
Cherin	Clive
Diannne	Creighton
Aida	Wendel
Karlen	Arni
Vivie	Glynn
Joanie	Dennison
Elinor	Rockie
Kaile	Brenden
Kissee	Chancey
Adela	Alexander
Alanah	Chane
Othelia	Erich
Francesca	Chrissie
Viviyan	Carling
Vivianne	Carl
Janaye	Gifford
Veradis	Tad
Janot	Hervey
Domeniga	Manuel
Ebba	Reynolds
Davita	Stanleigh
Brandise	Lars
Almeta	Mauricio
Willie	Arley
Teddi	Hashim
Constance	Kenneth
Lynett	Noah
Malia	Nathaniel
Conchita	Conney
Alexandra	Lowrance
Ninon	Ulysses
Liesa	Richardo
Audie	Broderic
Tommie	Dimitri
Marleah	Lew
Hallie	Nichole
Maryrose	Louis
Cori	Lucho
Judi	Quinlan
Trish	Vite
Joell	Pierre
Correna	Ewell
Catriona	Dana
Gabbie	Horace
Mandi	Jan
Emmie	Reuven
Freddi	Clair
Auria	Harald
Hetty	Nobe
Cassie	Salem
Phillie	Reinwald
Xenia	Homer
Myrah	Mattie
Charla	Elnar
Wileen	Matthew
Drucie	Lindy
Danella	Keane
Abagael	Carr
Shani	Josias
Ajay	Adolphe
Cristie	Jessie
Zonda	Zerk
Jessalyn	Jareb
Olympe	Granville
Corabella	Thurston
Myranda	Jerrome
Adelle	Dore
Winonah	Briano
Lilith	Shermie
Corine	Bret
Imogen	Judas
Carmine	Murdock
Bathsheba	Salvidor
Jehanna	Weston
Kit	Brice
Rorie	Forest
Walliw	Cash
Fidelity	Thorsten
Barbee	Nehemiah
Ashli	Bartolomeo
Iolande	Burty
Corissa	Nico
Erma	Cecilio
Adele	Tab
Nananne	Derk
Lorry	Griff
Nataline	Patrick
Amalie	Kelvin
Conni	Patten
Antonie	Merwyn
Consuela	Muffin
Dyanna	Mortie
Ricky	Corrie
Veriee	Edan
Diane	Chauncey
Nada	Ximenez
Amara	Daron
Loella	Thurston
Nancy	Gavin
Kizzee	Gage
Zaneta	Boycey
Carolan	Kenny
Wini	Riordan
Querida	Giordano
Toma	Philbert
Wren	Drake
Angy	Desmund
Abby	Sydney
Faina	Arvin
Ula	Giordano
Stepha	Vito
Joyan	Hoebart
Allx	Dame
Reina	Wes
Esma	Moises
Henryetta	Dalton
Catlee	Roi
Jillana	Jereme
Mimi	Jessey
Dore	Alan
Kalindi	Parsifal
Ferdinanda	Joshua
Tory	Ilaire
Kare	Shane
Terry	Peterus
Grata	Rees
Gates	Frederich
Saundra	Ado
Ariadne	Zeke
Goldina	Barrie
Mireielle	Gregoor
Orsola	Hashim
Anselma	Alejandro
Evonne	Cooper
Fidelia	Yance
Kathlin	Chrisse
Cari	Hailey
Goldia	Bertrand
Marybeth	Dallon
Libbi	Yorgos
Sybilla	Ugo
Katina	Virgilio
Tammy	Ignatius
Christian	Marlow
Sena	Paige
Gale	Roberto
Brooks	Artus
Ansley	Melvin
Mureil	Ellswerth
Ami	Hurlee
Lethia	Huberto
Debor	Rafi
Angie	Pietrek
Marion	Theodore
Miquela	Frants
Fred	Kristoffer
Elsa	Galvin
Katharyn	Fitz
Cammy	Gallagher
Dedie	Christy
Jacklin	Hughie
Jodie	Benedikt
Marieann	Nobe
Evie	Case
Jobye	Waring
Adrian	Em
Danika	Bob
Mel	Judon
Karrah	Aloysius
Glori	Irwinn
Merle	Findlay
Kyla	Hart
Phyllys	Tucky
Aleece	Richardo
Aile	Armstrong
Lusa	Haroun
Genia	Angeli
Beatrice	Pace
Selma	Antonin
Alexi	Webb
Simonne	Tris
Marysa	Shayne
Cassey	Dilly
Kessiah	Ethelred
Jessika	Andrea
Cher	Quill
Chelsy	Guy
Jenilee	Mikael
Lizzy	Nial
Klara	Winn
Guendolen	Humberto
Rochell	Rockie
Calypso	Lamond
Xylina	Gilberto
Daffy	Abbot
Simone	Irwinn
Blaire	ErvIn
Katerina	Yorker
Mavra	Lezley
Lynnette	Darren
Vonnie	Dag
Zorine	Brewster
Lynnet	Raff
Aimil	Garek
Theresita	Tan
Tova	Hewitt
Audra	Fritz
Inna	Jackie
Marney	Fonsie
Luella	Alonzo
Sally	Amery
Jerrine	Griswold
Sofia	Currie
Amata	Pren
Pamella	Denis
Trula	Samson
Vanny	Gav
Pandora	Ingelbert
Gabrila	Griff
Shalne	Husain
Mignon	Aurthur
Hyacinthia	Berke
Aurlie	Thom
Sayre	Sam
Leontine	Scott
Rozanne	Orazio
Isabella	Kristian
Jaquenette	Wilfrid
Nisse	Garrik
Ileane	Garner
Glyn	Ashlin
Micaela	Micah
Lonna	Christoph
Lissie	Pascal
Hestia	Walton
Georgiana	Alvy
Correna	Trey
Lishe	Don
Sal	Fin
Rayna	Alasteir
Danila	Grove
Rickie	Sherman
Krystle	Pooh
Marcela	Julio
Fredelia	Cori
Faith	Maximilianus
Margaretta	Hanan
Bernete	Irwin
Caro	Billie
Kinna	Hercules
Jemmy	Kennett
Melesa	Osbourn
Layne	Quinn
Caria	Morry
Adelind	Lanie
Chere	Barbabas
Anastasie	Eugene
Fawnia	Chickie
Winni	Bryn
Leonelle	Andros
Nessi	Jordon
Selle	Tully
Simona	Chauncey
Ardenia	Jarrad
Ynes	Nealon
Yolanthe	Hamlen
Christine	Templeton
Grissel	Lefty
Jilleen	Julian
Blythe	Kienan
Juanita	Ab
Luce	Curtis
Katinka	Tirrell
Elaine	Cory
Roanne	Brewer
Andria	Obadiah
Selene	Saunderson
Dulcinea	Erek
Moina	Parker
Rochette	Baudoin
Madelle	Vincenz
Valentia	Killie
Alissa	Onofredo
Arlinda	North
Elfrida	Julius
Davina	Padraic
Bonnibelle	Marius
Cristionna	Andre
Shaylah	Marv
Prudi	Crichton
Tilly	Edmund
Reeva	Dom
Melania	Leonerd
Biddie	Kean
Fancie	Marwin
Mickie	Barron
Gerda	Rogers
Ronny	Riordan
Grier	Lou
Adah	Antone
Elfrida	Vaughan
Eran	Hollis
Vivyanne	Laird
Genvieve	Karoly
Janeta	Barnett
Jessalyn	Nils
Eimile	Norman
Malorie	Franzen
Martelle	Elijah
Jennette	Kingsly
Andee	Tremaine
Blithe	Thedrick
Eva	Byrom
Austine	Adan
Imogen	Craig
Ciel	Townsend
Esme	Bale
Devinne	Vaughan
Trescha	Chic
Lindsey	Fergus
Kati	Jarvis
Kelly	Winnie
Annaliese	Flinn
Reta	Neel
Teresina	Stan
Nessie	Sergei
Lexis	Nevin
Sharlene	Martie
Dody	Zeke
Mechelle	Sigmund
Winnie	My
Zulema	Kippar
Wini	Penny
Margarette	Chev
Rochette	Rutherford
Hestia	Earlie
Catarina	Jozef
Erminia	Stearn
Eddie	Cad
Almeta	Sol
Helen-Elizabeth	Taddeo
Jade	Dunstan
Calley	Jarad
Corinna	Nappy
Alicea	Costa
Jessie	Torr
Ofelia	Antonius
Sheelah	Drake
Claribel	Costa
Celinka	Udell
Nedi	Thorpe
Ariel	Gran
Kipp	Dario
Poppy	Jeddy
Dania	Webster
Miriam	Sandor
Denise	Dalli
Carmine	Randal
Lynnette	Baxie
Kristen	Jarrett
Niki	Chane
Diane-Marie	Axel
Aarika	Patrizio
Diahann	Myron
Edythe	Armand
Loella	Geoffrey
Lynette	Sergei
Dorotea	Rochester
Roxie	Raynor
Candi	Gordon
Cher	Leonardo
Anatola	Kendal
Nessa	Anders
Evangelia	Clement
Maurita	Far
Morna	Mendel
Pris	Abdul
Sue	Prince
Kara-Lynn	Boyce
Hetti	Beltran
Nicoli	Ruben
Dyanna	Dante
Timi	Rodge
Riki	Englebert
Salaidh	Silvan
Nariko	Dallis
Shaylyn	Abelard
Jacinda	Zolly
Quinta	Jimmy
Laurena	Norris
Arleen	Woodie
Lindsay	Larry
Dot	Bartlett
Prudence	Cole
Lucie	Irvine
Anabella	Deck
Shandra	Vail
Rosie	Sterling
Sibyl	Clyde
Jorie	Waldemar
Judi	Cody
Isabella	Hersh
Leda	Adolpho
Elyn	Louis
Corabelle	Robin
Jeanine	Clyve
Sisile	Jeno
Jannelle	Ansell
Jaquith	Isidro
Mireille	Yehudi
Mildred	Cello
Sherye	Seth
Jacquenetta	Padriac
Babette	Standford
Farrah	Alvis
Arline	Goddard
Karissa	Morly
Lucky	Locke
Cindelyn	Forster
Charyl	Jeramie
Adorne	Robinet
Lisetta	Jeremias
Liuka	Cazzie
Aleda	Jud
Sean	Mord
Lia	Udell
Janeva	Yardley
Juliet	Rafaello
Koressa	Talbert
Ceciley	Lowe
Zaria	Vernor
Eugenie	Markos
Delilah	Tobe
Gertie	Bear
Deanna	Egon
Donelle	Rufus
Rosana	Rolland
Danell	Alvy
Whitney	Zollie
Anne-Marie	Jakob
Con	Giorgi
Trish	Lindsay
Timmi	Tate
Lilian	Humbert
Kary	Mickie
Gunilla	Skylar
Sher	Welsh
Ardys	Tadd
Rebecca	Simone
Enid	Lanny
Madelena	Brant
Rozalin	Isaiah
Corinna	Barrie
Kristi	Wayland
Emmi	Valle
Ilsa	Archibold
Mariann	Alaster
Shina	Frazer
Brande	Hansiain
Agnella	Swen
Sheena	Caldwell
Dulci	Tremain
Rani	Garald
Trina	Rock
Fara	Raviv
Bobette	Simone
Bridget	Nicko
Rivi	Walton
Dyanna	Miguel
Twila	Peyton
Evaleen	Ely
Loutitia	Omero
Marley	Dew
May	Rocky
Lonni	Shell
Grete	Tybalt
Sari	Nikolas
Flo	Halsey
Waneta	Peirce
Georgine	Papageno
Noreen	Delano
Leonie	Howey
Helyn	Lonnie
Leyla	Tedman
Bianka	Rustie
Amelia	Fee
Vilma	Birch
Stepha	Salomon
Gaynor	Neall
Jocelyne	Iosep
Malissia	Germayne
Brandi	Lyn
Maryann	Ruperto
Bryana	Wayland
Beatrice	Skippy
Lanie	Durward
Trina	Wiatt
Anni	Bill
Jenny	Andy
Bernice	Tucky
Cordelia	Griff
Aridatha	Matthias
Odella	Park
Clarey	Major
Alexandrina	Ashton
Eran	Jarib
Lauryn	Nickie
Willyt	Waldemar
Antonia	Keefer
Flo	Brent
Glori	Egon
Cassey	Francklyn
Celka	Wainwright
Giustina	Finley
Goldie	Obediah
Agace	Riordan
Chrissie	Marlowe
Pris	Layton
Christabel	Alexandros
Loralyn	Corney
Mariann	Parry
Nanny	Tab
Kynthia	Gasper
Lucina	Hugibert
Kass	Jerad
Oriana	Bartie
Rhianna	Drugi
Winna	Jaime
Hallie	Con
Cordelie	Mathias
Jessalin	Bar
Mead	Ximenez
Cleopatra	Shermy
Xylina	Gabriello
Amii	Syman
Becka	Mitch
Ilka	Akim
Gretal	Orson
Gillie	Kinnie
Jillian	Pryce
Corliss	Nil
Gabriela	Conan
Tatiana	Llewellyn
Correna	Hashim
Rosamond	Leonhard
Marlena	Agosto
Lyndel	Niles
Camila	Kevan
Cathe	Timmy
Gnni	Dale
Rosalyn	Sauncho
Staci	Codie
Katrine	Preston
Jacquenetta	Johan
Orel	Travers
Ami	Olvan
Sybilla	Trever
Delcina	Franky
Stesha	Freedman
Samaria	Devy
Kellyann	Joe
Karole	Aristotle
Deva	Bryant
Wynny	Bryce
Reggi	Grannie
Micki	Rowen
Addia	Karel
Anet	Alard
Tessa	Martyn
Vivie	Fabien
Shanta	Padraig
Maura	Baudoin
Ariella	Wilt
Piper	Tito
Lu	Taber
Tedra	Tremayne
Lyndsey	Freddy
Bridie	Trefor
Donnamarie	Frazier
Torrie	Lyle
Micaela	Jimmy
Rosy	Bondon
Camellia	Lorant
Aurelea	Kelvin
Donnie	Laney
Brianne	Derk
Merrilee	Alaster
Selestina	Marty
Glori	Langston
Terza	Robinson
Valerie	Solly
Winny	Mikey
Brear	Halsy
Aeriela	Antoni
Gilberta	Bradney
Lolita	Ian
Jermaine	Clemens
Leontine	Carolus
Anthiathia	Jeffry
Peria	Washington
Suzie	Aldus
Zorine	Bail
Prissie	Giacopo
Georgina	Gery
Rebekah	Claudius
Pamelina	Casey
Marcie	Sigismund
Blondy	Sheff
Jojo	Humfrey
Leontine	Brocky
Kym	Homere
Opaline	Laughton
Gusta	Ignaz
Helenka	Berkie
Malynda	Padriac
Erena	Alfredo
Cassie	Sutton
Cornie	Wilt
Delora	Garald
Clarey	Salomo
Laura	Abramo
Leigh	Farlie
Daria	Derby
Karlee	Vito
Mireille	Bill
Melly	Silvester
Matilda	Lowell
Noella	Hy
Raynell	Kevan
Ellene	Pinchas
Lina	Tanny
Tracy	Lev
Timothea	Tomas
Fancie	Fitzgerald
Luz	Ingra
Jacenta	Kirby
Jenilee	Magnum
Nicol	Sig
Marlane	Tabor
Kamilah	Berky
Odille	Derron
Gweneth	Archibold
Nichole	Ingra
Hildy	Lorant
Marline	Frederich
Neilla	Con
Lynnette	Berton
Henka	Merell
Cinderella	Nefen
Bobbe	Shurlock
Debora	Dominic
Viviene	Nicko
Netty	Archibaldo
Tony	Hirsch
Mariska	Kellby
Patrizia	Bobby
Anissa	Brett
Nicoline	Jozef
Harriet	Lawry
Hildy	Hobard
Chlo	Darill
Iona	Rowan
Cornelia	Ferd
Margaret	Moore
Toma	Cyril
Sarine	Bevon
Jami	Lind
Farrah	Andris
Darryl	Bailey
Cammy	Dimitry
Cati	Lazar
Leigha	Avrom
Gerda	Yorgo
Jocelyn	Ogden
Quinn	Gerri
Sydel	Royce
Tonye	Bernard
Heddie	Bryon
Karlen	Adams
Gilberte	Brice
Peta	Manny
Ines	Wells
Evanne	Sigismondo
Charla	Yehudi
Lory	Efren
Hermine	Jerrie
Karleen	Ryon
Sara-Ann	Swen
Micky	Harlin
Rena	Galvin
Drucill	Delano
Lilia	Hugues
Silva	Theo
Aurelia	Osgood
Michelina	Garvy
Dasie	Shadow
Kit	Lorne
Kristin	Moore
Hayley	Jessey
Quentin	Jarret
Eula	Chaim
Pandora	Chilton
Melisse	Hervey
Carina	Ignace
Joan	Lane
Riane	Haze
Elsy	Andrey
Maggie	Townsend
Loise	Nobie
Coral	Derek
Ranna	Bank
Lilly	Goddard
Edin	Grannie
Flori	Graham
Karlotte	Langsdon
Audrey	Ailbert
Amii	Kenn
Viviana	Bowie
Gaylene	Lenard
Aleece	Ringo
Rowe	Elihu
Malynda	Johan
Evonne	Nicko
Joan	Jimmie
Casie	Jonathan
Marga	Corey
Julita	Clive
Lesly	Uriah
Olivie	Shurlocke
Kitty	Zolly
Ursula	Omero
Tamarra	Roger
Jobyna	Lowrance
Stephine	Mannie
Lynnelle	Toby
Jacenta	Aksel
Ninon	Mic
Meriel	Robers
Elita	Nelson
Shayla	Ali
Viole	Lewiss
Vera	Oberon
Berni	Tybalt
Josefa	Clemente
Seline	Louie
Deina	Tailor
Alana	Vaughan
Teriann	Neddie
Denise	Virge
Drucie	Godfrey
Amil	Andros
Malinde	Lalo
Wilhelmina	Jeromy
Amalle	Corbet
Brande	Jamie
Maure	Pippo
Tersina	Daryle
Juliet	Hakeem
Teddy	Bogey
Dido	Bartholomeo
Andrei	Skelly
Nydia	Sander
Sheba	Lemar
Alleen	Norbert
Krystal	Bjorn
Sharla	Derick
Page	Dolph
Mattie	Rolf
Ronna	Smith
Perle	Thebault
Issy	Chucho
Starr	Rodolph
Linda	Lonnard
Jaine	Kilian
Karola	Lockwood
Tammi	Arne
Ashleigh	Holmes
Stafani	Darnell
Zorina	Hammad
Inge	Eustace
Pammy	Filip
Meghann	Renaldo
Guglielma	Lincoln
Kristal	Onofredo
Clementine	Bucky
Joannes	Rossie
Chloette	Des
Maxi	Erik
Sheri	Yehudit
Mary	Clarance
Sharlene	Lewiss
Lulu	Otis
Barby	Jae
Xaviera	Richardo
Edithe	Kaiser
Jacklyn	Fairfax
Ingeborg	Rustie
Colette	Tanney
Lanni	Gunter
Nessie	Darrel
Josefa	Maxwell
Carree	Nev
Cordi	Batholomew
Rona	Neils
Isabelle	Gilbert
Bella	Michail
Mommy	Cos
Aurore	Harley
Marnie	Kendall
Gisele	Osmund
Bernardina	Kean
Allx	Hubie
Willette	Skye
Ralina	Stavro
Laurella	Toddie
Kimmi	Amby
Edi	Ian
Kaitlin	Kiel
Marley	Dugald
Brigida	Royall
Martha	Lazaro
Helene	Jarrett
Haily	Lammond
Alicia	Oberon
Melonie	Julian
Sisile	Ricki
Gloriane	Fraze
Karylin	Cyrus
Gwenny	Randal
Rivkah	Brod
Harriett	Bendick
Juline	Tann
Geneva	Ignace
Sabrina	Frankie
Trula	Denys
Beverley	Arlen
Dorthea	Bernarr
Elfie	John
Drucill	Alberto
Ag	Troy
Hally	Royall
Karrah	Wes
Jackie	Heywood
Abbi	Brent
Laryssa	Ellsworth
Dianna	Gray
Fan	Lezley
Alyssa	Randi
Wendye	Dexter
Lavena	Paxton
Joelynn	Barthel
Sharlene	Pail
Eada	Wain
Hortensia	Erick
Ileane	Whit
Denys	Lewie
Goldi	Finley
Philly	Dilan
Bellina	Lewiss
Ki	Franklin
Bert	Howey
Olia	Pattin
Annaliese	Joshua
Devinne	Quincy
Alta	Teddy
Kristan	Zacharie
Margeaux	Chucho
Lilian	Dag
Eddie	Humfrey
Cathrine	Garvin
Elsinore	Kahaleel
Robbi	Callean
Perl	Dru
Lianna	Milt
Ronda	Dall
Berti	Patsy
Ivett	Boycey
Vivie	Anatole
Else	Perren
Christine	Alberto
Olivie	Bentlee
Gusta	Rudie
Allie	Angus
Ivy	Abba
Chrysa	Kev
Emelda	Filberto
Karleen	Darius
Naomi	Alphonse
Angele	Mace
Jsandye	Nicko
Winni	Baird
Sibelle	Vladamir
Ariela	Nevile
Caron	Luca
Alica	Giovanni
Tamara	Klemens
Gerta	Hammad
Ora	Farrel
Carolina	Eben
Mable	Sergio
Denise	Allan
Bert	Ole
Mariana	Cobbie
Marie	Brew
Roda	Ned
Vivyanne	Irving
Idelle	Omero
Wylma	Vincenz
Ginevra	Chip
Junette	Currey
Cesya	Raffaello
Wrennie	Karl
Gustie	Marv
Hollyanne	Curcio
Meris	Erin
Danyette	Shem
Catie	Rafaello
Terry	Marchall
Emmaline	Tyrus
Riane	Symon
Jolynn	Thatch
Rosabella	Conrado
Wenonah	Travers
Randee	Duke
Caye	Timmie
Clio	Dallas
Ardis	Bank
Mirella	Leon
Catina	Dillie
Jennifer	Russ
Gretel	Riley
Salome	Tann
Auguste	Rockey
Appolonia	Sutherlan
Nannette	Alexis
Portia	Arri
Jade	Freemon
Maddi	Kingston
Gwendolin	Rustin
Ariela	Roi
Kira	Maxim
Modestia	Yule
Giulia	Daryl
Hortense	Rory
Ynes	Franchot
Amie	Land
Jennee	Guillaume
Darelle	Anson
Hatti	Sydney
Orsa	Hamlen
Leigha	Court
Dyane	Dalton
Malvina	Marco
Eleanora	Jarib
Evelina	Harold
Sibylle	Petr
Willa	Allayne
Gipsy	Orson
Natalina	Gardie
Kamilah	Nowell
Kanya	Somerset
Cyndy	Emmerich
Catlin	Morlee
Therine	Gustavo
Diandra	Earle
Carolina	Duffie
Brittani	Gregorio
Esta	Fidole
Lonni	Jude
Chad	Costa
Rosemarie	Farleigh
Brigitta	Barron
Tabbitha	Bruce
Vanda	Dore
Eulalie	Ahmad
Kerrin	Clemmie
Korella	Franzen
Philly	Husain
Ray	Sanders
Marlyn	Nevile
Steffane	Bendicty
Adina	Dana
Peggi	Ravi
Ines	Tamas
Elyssa	Benedikt
Tammara	Gianni
Elfrida	Rey
Shannon	Esteban
Adelind	Jayson
Michel	Keary
Eada	Raynor
Vania	Hercules
Chanda	Sampson
Maurine	Wake
Blisse	Darin
Mary	Nickie
Paula	Tannie
Tamar	Rowen
Jeniffer	Tucker
Betsey	Clim
Carleen	Saunder
Missy	Joshua
Jessika	Ringo
Kiah	Dalli
Fallon	Gardie
Debor	Bruno
Laina	Mendie
Nicol	Gerri
Jeniffer	Aldon
Annice	Steve
Billie	Fredek
Gisela	Tris
Beverlie	Cecil
Annecorinne	Neddie
Rosella	Creigh
Zara	Matthaeus
Garnette	Clair
Keely	Bucky
Jaquelyn	Tripp
Valaria	Milty
Maxi	Fields
Glen	Alejandro
Marysa	Mahmud
Torrie	Nataniel
Susana	Denney
Alyss	Creigh
Dorelia	Portie
Albertine	Butch
Elna	Sven
Alina	Cad
Carolina	Hurlee
Ninnetta	Malchy
Dedra	Luis
Suki	Kalil
Wini	Papageno
Adah	Lodovico
Sheela	Sanson
Ethyl	Franciskus
Heloise	Tobias
Alma	Abe
Jobey	Aksel
Jocelin	Paquito
Glynnis	Nehemiah
Marley	Gregoor
Eula	Godfree
Leesa	Ira
Dorothee	Dagny
Alvina	Nicky
Angeline	Ginger
Brigitte	Eldredge
Denny	Merell
Bernice	Rafael
Almira	Mendel
Honor	Arv
Wynne	Douglass
Trixie	Winnie
Aloisia	Towny
Angela	Frazier
Jenilee	Bronnie
Clem	Hobard
Pearl	Rudiger
Bonny	Brewer
Jorey	Charley
Odette	Fredric
Nixie	Boothe
Doralia	Rriocard
Christan	Franzen
Clio	Andros
Vivien	Freeland
Keslie	Konstantine
Phedra	Josias
Aridatha	Cad
Juline	Norman
Elladine	Barrett
Beverlie	Maximilien
Toby	Rudie
Lilith	Waylan
Katina	Wernher
Aleda	Salvidor
Rubetta	Giacopo
Jolene	Rodney
Dannie	Ossie
Cissy	Eadmund
Essy	Richmound
Henrietta	Carver
Nettle	Nathanial
Shayna	Basilius
Jennie	Micky
Ermentrude	Merrill
Erena	Bartholemy
Ethelin	Dukie
Paula	Niko
Harrie	Ode
Jade	Bordie
Karen	Way
Nydia	Vaughn
Buffy	Nevins
Nichole	Marv
Dorise	Dory
Selinda	Brodie
Tiphani	Zebulen
Marjie	Cleon
Jillana	Adolphe
Linnie	Erv
Georgena	Ewart
Phil	Ric
Judy	Vince
Malissia	Whitman
Ilyse	Ryley
Gwen	Trever
Adora	Denver
Lanae	Maje
Letta	Theobald
Tedda	Bo
Joceline	Mendel
Lyndell	Allie
Zea	Jay
Milli	Maxim
Anthe	Erny
Arly	Ty
Deana	Hubert
Melisent	Jephthah
Rosetta	Pippo
Valeria	Iosep
Jan	Cleon
Chelsie	Franciskus
Kiri	Robb
Valida	Ethelred
Adriena	Vern
Dallas	Oliviero
Alyse	Willie
Esther	Ted
Alfie	Frazer
Chere	Turner
Sheela	Patton
Yetty	Sterling
Libbey	Eward
Steffi	Arley
Marget	Noe
Cloris	Kristian
Kelsy	Demetris
Ernestine	Tulley
Pia	Domenico
Lurlene	Morgan
Aggi	Marijn
Blakelee	Aluin
Agathe	Llywellyn
Alane	Fairleigh
Cordula	Mike
Sarina	Vincent
Grete	Decca
Kacie	Lynn
Wynne	Llewellyn
Zorana	Grace
Dore	Pascal
Wynn	Tucker
Gilemette	Jerrome
Austin	Corrie
Brena	Fraser
Cynthy	Ker
Glenna	Fletcher
Mariejeanne	Jaymie
Camille	Hasty
Gennifer	Zeb
Allina	Benedikt
Tomi	Dun
Pearline	Tammy
Marylin	Putnam
Aggie	Riley
Ciel	Rochester
Shannen	Baxy
Willette	Tyrus
Aliza	Bernard
Leanor	Marcellus
Sada	Ethan
Adelina	Erastus
Lurette	Neill
Jo-Ann	Alisander
Jaquelyn	Niki
Nanny	Tadd
Drucill	Talbert
Staci	Uriah
Celia	Trefor
Hildagard	Levin
Tania	Dev
Roze	Bron
Genovera	Nicolas
Melisenda	Caleb
Ardisj	Bertram
Ellyn	Smith
Eleanore	Ward
Chad	Wilhelm
Eryn	Zacharias
Hannah	Russell
Eve	Vasili
Geri	Sheff
Illa	Archer
Dolores	Luis
Melisse	Horatio
Kaia	Brigham
Laure	Adolphe
Stormi	Giusto
Elsbeth	Hale
Lucita	Kristoffer
Melinde	Johny
Wendie	Alley
Cornelia	Raoul
Gaylene	Vasilis
Lainey	Lew
Desirae	Chris
Georgeanne	Townie
Kelsy	Joaquin
Arlene	Malachi
Darsey	Franny
Ariel	Owen
Alina	Axe
Jaquelin	Morse
Drucill	Thacher
Margarete	Leonid
Hermina	Dominique
Bobbye	Gardner
Adela	Filbert
Shirlene	Tarrance
Norean	Frederico
Ricky	Dwayne
Florida	Stanfield
Blancha	Clemmie
Jasmin	Demetris
Rubie	Bertrand
Twila	Burtie
Edee	Mitchell
Ethelind	Ernie
Marni	Christophe
Cathleen	Glenn
Wrennie	Teodorico
Anabelle	Xymenes
Suzanne	Harlan
Tommy	Bald
Vivian	Duane
Benny	Dimitri
Sher	Travers
Natassia	Steward
Bethanne	Eben
Marlena	Sargent
Kali	Donnell
Merci	Curtis
Carine	Darill
Marjie	Darin
Lianne	Garrard
Heidi	Joachim
Mavra	Merry
Nancey	Donavon
Beryl	Sergeant
Millicent	Grove
Carmel	Corty
Norma	Tremaine
Adela	Barnabas
Catharine	Oran
Abigail	Ram
Barbey	Emmett
Arleyne	Sigismondo
Blinny	Reinwald
Donna	Hirsch
Anne-Marie	Natty
Fanni	Alvis
Cristine	Antonio
Joana	Nester
Dominique	Robinet
Kira	Elnar
Elysee	Darbee
Calley	Maximilien
Tanhya	Trefor
Sorcha	Bradan
Nikoletta	Zacherie
Kathi	Anatollo
Anselma	Jedidiah
Isadora	Tanney
Anya	Reinold
Genevieve	Arlen
Tootsie	Pincus
Sasha	Jecho
Reena	Maje
Jacquenette	Harvey
Ardelia	Jeramie
Belita	Martino
Shell	Jeramie
Jojo	Winthrop
Elizabet	Lazarus
Jamima	Farr
Blinny	Lindon
Cathlene	Marve
Sharline	Jonathan
Hermina	Thane
Gwyneth	Berke
Babb	Barrett
Georgeanne	Lamont
Yvonne	Neale
Elaine	Matthiew
Ashely	Ingram
Idalia	Reed
Naoma	Norris
Ruby	Gabbie
Neala	Mattie
Ida	Tynan
Donny	Thorstein
Nariko	Alexei
Peg	Isidore
Glori	Tuck
Dulce	Forest
Lisha	Huntington
Jilli	Baillie
Terza	Clevey
Eadith	Free
Eveleen	Bank
Pavia	Vernor
Felicle	Waylen
Myrta	Denis
Carmen	Harvey
Lizbeth	Aurthur
Indira	Aksel
Candra	Tymothy
Kathe	Emlyn
Susy	Gaylor
Mavra	Huey
Mari	Bradly
Bryana	Roderic
Renate	Arny
Jaclyn	Will
Rebecka	Case
Joanie	Ingamar
Milissent	Morse
Dulcine	Wilfred
Biddie	Adamo
Arleta	Orbadiah
Sonny	Herc
Arabelle	Jacobo
Ashlie	Harcourt
Orsola	Silas
Martie	Matthias
Ida	Thorpe
Erina	Cesare
Hailee	Worthington
Orsola	Thane
Pier	Lonnard
Trixi	Lalo
Xenia	Raimondo
Saidee	Scot
Eolanda	Iosep
Grayce	Waite
Blinni	Turner
Aurelia	Bordy
Karen	Hew
Cecelia	Porty
Genevieve	Sheff
Adora	Tobin
Evania	Kenny
Maria	Allie
Jeanette	Billie
Roanne	Zebadiah
Corinne	Ricki
Ethelyn	Farly
Ginny	Giorgi
Erika	Falkner
Daria	Garald
Maddi	Jacky
Tawnya	Rudolfo
Arlinda	Kelsey
Deirdre	Fernando
Danyette	Inglebert
Ebba	Ulysses
Casey	Julius
Suzie	Quent
Georgette	Arny
Hana	Zak
Rosalind	Burlie
Joni	Bruno
Dolly	Devland
Jacky	Tudor
Fayette	Mayor
Dina	Holt
Mimi	Arnaldo
Jocelin	Onofredo
Donnamarie	Dietrich
Viola	Walt
Kania	Weston
Austine	Percival
Anthea	Yule
Yasmin	Tanney
Bell	Raviv
Nathalie	Shurwood
Julita	Spenser
Gisella	Travis
Roanne	Lorenzo
Fiorenze	Alon
Evey	Elmer
Melissa	Domenico
Patrice	Henderson
Con	Pieter
Teresina	Natal
Adel	Pierce
Farah	Jo
Cristy	Quillan
Min	Orin
Tisha	Jarrett
Kathie	Gardie
Lina	Lloyd
Jemie	Alvan
Tamiko	Yancey
Terry	Alejandro
Natasha	Jamie
Ania	Gregory
Norri	Gilles
Clemmie	Zedekiah
Guillemette	Angelo
Terese	Bartholomeo
Elfie	Hurley
Marcelline	Eugene
Karylin	Shep
Karleen	Maynord
Daveen	Derron
Dacie	Garrot
Catlin	Caddric
Brandice	Agustin
Silvia	Burch
Chloe	Casey
Ellissa	Godfree
Lil	Dana
Nanon	Nikolaos
Ashia	Thornie
Vittoria	Geoffry
Leland	Kale
Hadria	Donovan
Cherry	Natal
Ashli	Griswold
Danita	Even
Dulciana	Edgardo
Brana	Artur
Nerti	Antonius
Jorrie	Cesare
Rene	Chadwick
Charlot	Normie
Faina	Xymenes
Meghan	Carrol
Minerva	Tristan
Janina	Carney
Ailyn	Davidson
Helli	Fred
Michal	Ferd
Juanita	Calv
Rosalind	Witty
Bette-Ann	Justis
Carmel	Dimitri
Trula	Avram
Velvet	Talbert
Jerrylee	Peyton
Leelah	Bondie
Madeleine	Gregg
Kailey	Bud
Tybi	Kayne
Thomasin	Pattin
Storm	Arnold
Andi	Perry
Stacee	Lalo
Jacquette	Siegfried
Kelsey	Dall
Marcy	Morty
Dawn	Vidovic
Amata	Brian
Valera	Arv
Carmella	Zack
Cyndie	Giffer
Bili	Tobin
Georgianne	Gothart
Marie-Jeanne	Barth
Meggy	Tremaine
Saree	Delano
Chicky	Elwin
Dawna	Tripp
Tobi	Benjie
Jade	Bevin
Adel	Derrik
Amalee	Yehudit
Gayleen	Derry
Lorine	Graeme
Cherilyn	Cross
Sabine	Gaby
Isabelle	Gardener
Floris	Mattheus
Tressa	Donn
Bobbie	Renato
Sonnnie	Benoit
Carlene	Mychal
Liesa	Kirby
Jenna	Tod
Georgine	Esteban
Kellyann	Clair
Ursuline	Ali
Lacie	Karl
Devonna	Walther
Tiffany	Finlay
Sarine	Alfonso
Dominga	Spencer
Iolande	Ingram
Maude	Torrence
Melania	Merrick
Lory	Odey
Moll	Virgie
Hyacintha	Ilaire
Mallory	Decca
Danielle	Huntlee
Isahella	Buck
Garnette	Kennan
Jeannette	Randolph
Elinor	Emmet
Olympie	Lon
Margery	Matthus
Concordia	Germain
Ilsa	Ignacio
Gusti	Davey
Kamilah	Dalt
Lura	Reggis
Carey	Hurlee
Charlot	Tomas
Wilone	Huntley
Jaquenetta	Zach
Caron	Timotheus
Risa	Rudy
Selina	Spike
Gwendolen	Trumaine
Mahala	Keven
Mariam	Gerardo
Kylie	Sutherlan
Herminia	Galen
Ameline	Osgood
Anthea	Wayland
Poppy	Ashlin
Analise	Fredek
Tanitansy	Stan
Naomi	Scottie
Lanette	Dennet
Rasla	Chrisy
Emylee	Morton
Aubree	Neall
Dinah	Hobart
Ardath	Hyatt
Genovera	Aylmar
Estelle	Rhys
Rhea	Quent
Matti	Dill
Tatiania	Waite
Wynny	Dav
Dorie	Shelby
Jazmin	Alfonse
Jacquenette	Frederico
Melissa	Sholom
Cathrine	Garey
Jamima	Kristian
Collete	Svend
Madalena	Tait
Madelyn	Jacky
Harlie	Spense
Maryjane	Forester
Katharyn	Garfield
Lenna	Bartel
Glory	Benjy
Malory	Sheppard
Nathalia	Judon
Laney	Vaughn
Fenelia	Sylvester
Kylila	Chucho
Claudine	Antonius
Marj	Arne
Monika	Mischa
Berny	Erek
Brigitte	Miles
Cacilie	Gearard
Kym	Correy
Dyan	Gideon
Mandie	Tremayne
Ketty	Nico
Katrinka	Darb
Verna	Luigi
Dasha	Elwin
Christyna	Iain
Ulrike	Terrell
Dredi	Lonny
Ethelda	Gordie
Tildie	Brnaba
Aloysia	Alanson
Sybyl	Matty
Fania	Waldon
Dasya	Menard
Ketti	Isidor
Randie	Thedric
Verena	Elvin
Kassi	Silvain
Joete	Ulises
Franny	Neville
Lesya	Philip
Marcellina	Roderich
Marchelle	Bev
Corabel	Reagen
Noni	Shepperd
Eolanda	Jacques
Gert	Judah
Audy	Bentley
Lanae	Obadias
Flor	Murdock
Francesca	Mattheus
Bessy	Miltie
Yolane	Calhoun
Darcey	Tomkin
Tessa	Dewey
Deena	Nico
Chrystel	Bancroft
Fifi	Clemmie
Flossy	Costa
Danika	Butch
Rhianon	Norton
Annmaria	Nikolos
Ali	Horatio
Megan	Cully
Faustina	Reinaldos
Vina	Merill
Ertha	Dermot
Cyb	Ches
Eddi	Nicol
Blondelle	Devy
Renae	Brander
Reta	Thaxter
Kelci	Ethelbert
Irena	Riobard
Ronni	Waldemar
Rasla	Claudio
Brittaney	Brig
Rochell	Nathanial
Ebony	Darrick
Ardella	Gal
Lydie	Kingsley
Shandra	Buddie
Ferdinande	Davis
Madelyn	Scotti
Reyna	Urban
Fawn	Fabien
Liana	Tony
Nollie	Hagan
Elnore	Mic
Kellsie	Hilarius
Ivette	Oren
Floria	Samson
Claudette	Denney
Marlee	Vladamir
Robinett	Rock
Krista	Godfrey
Karina	Barrie
Sonni	Leonid
Holli	Padraic
Vivyanne	Wilmer
Francisca	Jonathon
Tamera	Seth
Eden	Kerby
Audrie	Christiano
Adena	Garrard
Ursula	Hugo
Bernadine	Gunther
Margret	Berky
Rita	Rudolfo
Doria	Gustavo
Deny	Crosby
Didi	Cleavland
Vivia	Izzy
Cassandre	Bogart
Dorothy	Martino
Kimberley	Farley
Alia	Wilburt
Lucine	Guntar
Lilith	Patricio
Umeko	Robinet
Phillie	Griffin
Donnamarie	Inglebert
Koral	Darcy
Frankie	Sayer
Reeva	Stan
Brier	Hansiain
Joyan	Brock
Vinnie	Gaston
Rosemary	Gabriello
Evelina	Graig
Eryn	Jorge
Melita	Delaney
Gipsy	Nil
Lynnett	Puff
Maurizia	Bernhard
Mireille	Gilberto
Quinn	Seth
Alex	Buck
Larissa	Georgy
Lara	Spence
Lonni	Thatch
Reine	Thornie
Gussie	Kendall
Colline	Thane
Ermentrude	Maurice
Susan	Wendel
Dacia	Kingsly
Cathie	Barrie
Babbie	Fabio
Dale	Isak
Trix	Lovell
Odessa	Kinnie
Georgeanna	Barnabas
Eugenia	Hyman
Gae	Raimondo
Jenna	Rorke
Maggee	Sayers
Sheri	Will
Ynez	Delainey
Tildy	Barnabas
Orelee	Maxy
Fifi	Sheppard
Waly	Farlee
Darsie	Randie
Dell	Boothe
Elberta	Lawry
Celie	Karlan
Persis	Nester
Arluene	Flory
Berti	Noland
Mattie	Waylon
Malynda	Marvin
Jannel	Orazio
Adrianne	Bernhard
Glennie	Glynn
Betteanne	Glendon
Zorah	Curcio
Nanete	Byrom
Mindy	Marcellus
Chrissy	Larry
Bernita	Marcos
Siana	Penny
Dona	Lindy
Rochella	Glenden
Drusie	Edgardo
Eba	Brigham
Merlina	Shay
Therine	Timotheus
Blithe	Myer
Carlita	Chevy
Quintana	Wilburt
Frank	Sheridan
Britta	Titos
Julia	Dan
Viviana	Noble
Valenka	Kendell
Cally	Jacky
Joyce	Hillery
Isabelle	Gamaliel
Eyde	Red
Fernandina	Levi
Alyssa	Jeremy
Zola	Miguel
Minetta	Findlay
Janel	Rickey
Dacy	Rudd
Codi	Gianni
Lyndel	Myrvyn
Ferdinande	Ravid
Cassaundra	Raddy
Gertrud	Reginauld
Myra	Micah
Charlene	Menard
Adah	Arvie
Elita	Alic
Deonne	Massimiliano
Rina	Wainwright
Darcey	Boycey
Tori	Augustine
Maggy	Rex
Elysee	Phillip
Mona	Salvatore
Megan	Matthiew
Gunilla	Lawry
Bryna	Sol
Violette	Bary
Nalani	Halsy
Shoshana	Goran
Auguste	Anthony
Donni	Gerhard
Donnie	Diarmid
Ezmeralda	Torre
Gabriell	Abram
Odilia	Mychal
Janelle	Ximenes
Mehetabel	Wolf
Legra	Seward
Kim	Ermin
Daffy	Sherlock
Gwendolen	Hymie
Charo	Aloysius
Gaylene	Ambrosi
Maible	Martin
Jaquelin	Carroll
Sharleen	Alford
Lisabeth	Florian
Ibbie	Otes
Karly	Montague
Suzanna	Grover
Shirley	Addison
Gabie	Laney
Stoddard	Tamas
Evangelin	Urbano
Lucita	Farly
Gene	Grady
Tanhya	Derick
Scarlet	Eduino
Sacha	Broddie
Ladonna	Natale
Caty	Garrot
Salli	Alberto
Sibylle	Jammal
Consuela	Raynor
Helaine	Jasen
Bea	Lowrance
Annalee	Land
Tierney	Siegfried
May	Austin
Randene	Fons
Noellyn	Lou
Arabele	Dunstan
Krystle	Zebadiah
Licha	Lief
Patsy	Goran
Tedda	Zachary
Mignonne	Nelson
Sharyl	Dwight
Judi	Jerald
Bonnibelle	Bordy
Christi	Ettore
Jonie	Roman
Malynda	Arnuad
Carolynn	Wilburt
Marika	Bentley
Papagena	Job
Viviana	Tracey
Lilli	Sayre
Flory	Harvey
Marena	Vergil
Eloise	Reginald
Perl	Abrahan
Batsheva	Emmy
Karrie	Corbet
Emeline	Rodney
Dita	Salvador
Elvira	Laurence
Shirline	Kenn
Audra	Zelig
Elwira	Hakim
Edi	Grantley
Marjory	Nikolaos
Rosmunda	Georgi
Ruthanne	Maddie
Marlo	Wakefield
Austina	Reginauld
Jacky	Trueman
Shannah	Eberhard
Theda	Gayelord
Cairistiona	Udall
Dorita	Mendel
Cherrita	De Witt
Inge	Christy
Donella	Westleigh
Kat	Mannie
Kayle	Rourke
Melanie	Ilaire
Reiko	Roley
Robby	Cole
Darryl	Costa
Stoddard	Tally
Yetta	Marcello
Kirby	Rodney
Noell	Morten
Abbye	Maxie
Fallon	Garrot
Caritta	Andrej
Ailey	Prince
Betteanne	Keary
Minnie	Arnie
Loreen	Verge
Merilee	Timotheus
Star	Phip
Trude	Fair
Marcie	Brian
Janela	Diego
Glyn	Allayne
Felicdad	Odey
Paige	Jory
Bessy	Cobbie
Jonell	Horst
Willette	Josiah
Sidonia	Whit
Malinde	Prent
Alexandrina	Alonso
Beatriz	Lezley
Margarita	Von
Joell	Gordon
Karia	Brade
Aubree	Sebastiano
Carmelina	Oswell
Deni	Udell
Oralla	Kennan
Gretna	Cornelius
Jacinthe	Phineas
Marylou	Zerk
Marthe	Brennen
Abigail	Patsy
Audie	Pierson
Aurelie	Maurie
Korella	Skipp
Rachael	Keane
Crin	Kristopher
Elnora	Winn
Helga	Juan
Nellie	Allan
Catlaina	Gare
Benny	Felic
Leeann	Wilmer
Tish	Peirce
Marlene	Grange
Hilary	Granger
Venus	Zaccaria
Caria	Eddie
Shawna	Filberto
Ulla	Pinchas
Alana	Henderson
Cammy	Barton
Mavis	Andres
Sheba	Alric
Rosemonde	Dal
Merle	Augustine
Darya	Buddy
Silvia	Berk
Perrine	Shaun
Jeanna	Kevon
Marcelle	Vincent
Ida	Aron
Dotty	Clemmy
Indira	Rafaellle
Nikki	Ozzy
Alfy	Kin
Reggie	Aldric
Sidonia	Tedman
Toni	Ole
Stoddard	Sinclare
Steffi	Pierson
Jacquie	Waring
Kata	Godart
Elfreda	Merle
Aurelie	Jameson
Nicola	Verge
Tiena	Ambros
Alexina	Kelby
Ettie	Orran
Alexine	Markus
Bibby	Heath
Ruthe	Axel
Jocelin	Darin
Doroteya	Dur
Bianka	Ingelbert
Maddie	Amos
Carroll	Lambert
George	Mikey
Nicky	Sheffield
Aurie	York
Beryle	Gris
Delcine	Rubin
Catherine	Carey
Joyan	Hasty
Adeline	Tabby
Gertruda	Tully
Danyelle	Mervin
Iona	Burt
Lilias	Toby
Serena	Byran
Renelle	Kenon
Pearla	Dalt
Ethelyn	Yuri
Stella	Madison
Drusy	Orson
Lynda	Karl
Jenny	Fernando
Rosie	Diego
Charla	Ezequiel
Sybille	Gregoor
Brittni	Woodman
Maryann	Archibaldo
Avivah	Wynn
Jennifer	Fabiano
Maye	Winny
Almeria	Peder
Lauren	Herby
Linnell	Steve
Karleen	Jess
Babbette	Linc
Susanetta	Corey
Petronilla	Herbie
Susannah	Bernardo
Agnesse	Albie
Theresita	Riley
Amandy	Gale
Iris	Leupold
Kristyn	Cornelius
Daniella	Shelton
Diana	Oates
Ferdinande	Milty
Juanita	Aharon
Ree	Traver
Lyn	Patricio
Mahala	Angeli
Betteann	Justinian
Nadean	Welby
Nadine	Maxwell
Jo-Anne	Bradly
Bobby	Edsel
Xylia	Carey
Natalie	Teddy
Rochella	Taddeusz
Susanne	Gaspar
Hannah	Gustave
Jayme	Brigham
Chrysler	Matthiew
Farand	Francisco
Binni	Marvin
Nata	Geordie
Ingeborg	Bengt
Jerrilyn	Barnabas
Nola	Kermy
Mignon	Bryce
Kate	Luther
Dori	Hillary
Brook	Towny
Seana	Irving
Elizabeth	Jethro
Annice	Vincenty
Ardis	Dietrich
Roobbie	Decca
Fulvia	Swen
Cecelia	Dud
Christiane	Kean
Helenka	Salim
Nari	Barth
Lorinda	Aloysius
Erma	Shaughn
Cleo	Goddart
Pearla	Parry
Wilona	Henrik
Viole	Charlton
Noell	Merell
Gustie	Fletch
Lurlene	Jasun
Lenette	Kiley
Kial	Meade
Sydney	Rudolf
Karlene	Freeman
Henrie	Chan
Martita	Rob
Rayshell	Randall
Loella	Roi
Callie	Adams
Coraline	Kennith
Johanna	Herve
Junina	Friedrich
Kirstyn	Lucas
Denni	Harris
Kaela	Ashley
Rheta	Pearce
Dannie	Arther
Cinnamon	Kayne
Kathleen	Conway
Tamqrah	Zachery
Eada	Hogan
Hortense	Kelvin
Carmela	Cleon
Adria	Garrick
Bert	Brig
Annmarie	Lukas
Florry	Winston
Dona	Humphrey
Magdalena	Garvey
Lavinie	Pancho
Marthena	Frasco
Carley	Adolphus
Marcie	Hernando
Eve	Jase
Kiri	Dionisio
Cynthia	De Witt
Celine	Humberto
Clareta	Ashby
Rosabel	Freddie
Valerye	Emanuel
Audrie	Gene
Katharina	Fleming
Tamara	Haven
Rosabelle	Vincenz
Dyana	Raynor
Mella	Ciro
Pauly	Conney
Elene	Caddric
Annie	Mannie
Debee	Brewer
Ysabel	Lon
Shelagh	Zelig
Nessie	Henri
Ricca	Matty
Lilah	Ellsworth
Kylen	Cob
Carissa	Stavros
Katerina	Timothee
Helyn	Thadeus
Cyb	Duane
Annabella	Orbadiah
Tarrah	Michel
Jacintha	Alvy
Rochelle	Reagen
Netti	Gaspar
Sib	Frannie
Leshia	Manuel
Coreen	Damiano
Elysha	Korey
Myrtle	Reggis
Lucine	Corrie
Hally	Elijah
Kathye	Herby
Brina	Marijn
Alisun	Crosby
Atlanta	Lezley
Elvina	Simon
Opal	Hall
Martica	Frederik
Erena	Hobard
Hailee	Hugo
Stesha	Evelyn
Ebony	Englebert
Illa	Osgood
Rosamond	Anselm
Alys	Theo
Jessalin	Alexio
Dody	Tedmund
Elsbeth	Rickie
Milena	Durand
Joelle	Meredeth
Lilias	Gil
Nadeen	Inger
Beverie	Odell
Brit	Rutherford
Alfy	Berke
Rhianna	Kingston
Marietta	Hamlin
Walliw	Ingra
Wilma	Roman
Brynn	Aldo
Margalit	Farr
Margaret	Binky
Stephana	Edmon
Rafaela	Ruby
Abbe	Carolus
Leda	Mendie
Ilse	Morgun
Janka	Artus
Patience	Timmie
Barrie	Alford
Barry	Grange
Sabra	Randy
Nannie	Waldemar
Paule	Fonzie
Beulah	Brook
Blondy	Lek
Darleen	Jordan
Kalila	Stacy
Meridith	Mort
Rosana	Deane
Gratiana	Cece
Katharyn	Edgardo
Briney	Web
Ursala	Denney
Georgianna	Vance
Carma	Cross
Madge	Patric
Jacquenetta	Meade
Edi	Ingra
Charline	Efren
Shir	Dillie
Eden	Shurlock
Katalin	Free
Gratia	Goraud
Willette	Andy
Cherey	Cord
Abagael	Bord
Frederica	Oberon
Yovonnda	Piggy
Hetti	Alexander
Liane	Friedrich
Tove	Maurizio
Celestine	Jeremias
Adelina	Hamish
Bobine	Arther
Stacey	Grenville
Elna	Bryce
Milka	Lindsey
Pearla	Percival
Correna	Hillary
Marlena	Udall
Joceline	Dan
Josee	Winnie
Jobi	Emanuele
Julie	Orran
Shalna	Daniel
Pippa	Jim
Adrienne	Berny
Nelli	Victoir
Ariadne	Harbert
Phyllida	Giulio
Koren	Brucie
Moria	Rufe
Shaine	Franny
Darbie	Yorker
Jacquenetta	Jeff
Kimberley	Nappie
Sal	Donall
Stevana	Rayner
Ingaborg	Edmon
Dixie	Hyatt
Lanae	Heriberto
Harrie	Roberto
Dena	Lenard
Nolana	Clemmie
Marney	Kelly
Carmine	Cleavland
Hatti	Percy
Emmye	Christoper
Jami	Kelby
Becca	Dall
Antonie	Ferdie
Adella	Lorrie
Flss	Teodorico
Franciska	Webb
Deni	Marlow
Ralina	Claire
Emlyn	Barde
Fancie	Dare
Aline	Penn
Aundrea	Cleavland
Leda	Hamlin
Lissa	Emlyn
Camile	Marion
Nellie	Juan
Jen	Cassius
Giorgia	Barrett
Josi	Efren
Corenda	Basilio
Biddie	Mathew
Alana	Teodoor
Emogene	Baxy
Teriann	Giorgio
Angele	Herb
Leonelle	August
Meridel	Port
Athena	Pietro
Julieta	Umberto
Annette	Randal
Reggi	Claudius
Lorianne	Andrus
Jess	Orazio
Golda	Orlan
Korney	Mason
Carree	Delmer
Cairistiona	Wendel
Faythe	Flynn
Jasmin	Cristiano
Saree	Yulma
Marne	Shep
Karla	Ferdinand
Selie	Patrick
Delcine	Tobe
Mechelle	Ike
Fredi	Amerigo
Freddi	Tynan
Janette	Humphrey
Andreana	Maurizio
Meta	Virgilio
Sheila-Kathryn	Thurston
Eudora	Bryon
Nicolette	Charley
Fredi	Mateo
Dedra	Ambrosio
Pen	Ax
Zarah	Dante
Julieta	Phip
Raquela	North
Adelice	Herculie
Charmian	Reggie
Lexis	Wells
Matti	Mannie
Jobye	Egon
Deanna	Heall
Adeline	Anatollo
Christean	Kiley
Kelly	Tudor
Ashely	Rudolfo
Lurleen	Frank
Annette	Ingram
Adiana	Paddy
Reyna	Terrel
Hedvig	Iorgos
Katrinka	Godfree
George	Vito
Cherri	Townie
Jody	Quintus
Josselyn	Tracey
Friederike	Darbee
Elaina	Brucie
Dulcinea	Bronson
Sabina	Erie
Nedda	Garvey
Demetria	Hervey
Dela	Davey
Gracie	Randal
Jen	Edd
Whitney	Fidelio
Edythe	Griswold
Ellen	James
Lucita	Mill
Natassia	Hillie
Adrian	Christian
Celine	Tuckie
Hetti	Abrahan
Junette	Gardiner
Allianora	Jerad
Norina	Rey
Elysha	Weber
Raeann	Valentin
Catie	Spense
Cynde	Fredek
Appolonia	Brewer
Leonora	Ebeneser
Kristi	Kristofor
Eugenia	Verney
Bernice	Norbie
Rianon	Burty
Bree	Jim
Karoly	Simeon
Addi	Archaimbaud
Missie	Zacharias
Adiana	Ellery
Allis	Orland
Geneva	Vick
Seana	Geoff
Jeanne	Fin
Anna	Obediah
Bea	Cletus
Adriane	Hadlee
Andeee	Bryanty
Leanna	Ellwood
Carlynn	Pebrook
Kelila	Gabi
Betsy	Wildon
Mersey	Dermot
Jenni	Colet
Erminie	Pacorro
Ailee	Claiborn
Antonia	Daven
Elwira	Hailey
Gypsy	Arnaldo
Merlina	Dmitri
Barbara-Anne	Jarid
Kimberlyn	Gunar
Cary	Ulysses
Dorie	Bertie
Ashlie	Kermy
Mariska	Eadmund
Marleah	Stern
Luelle	Jacques
Freida	Pierre
Hyacinth	Tammy
Cam	Tadeas
Bari	Ahmed
Marielle	Townie
Eirena	Ingemar
Jaclyn	West
Lin	Elton
Appolonia	Banky
Elora	Boony
Katerine	Maurise
Krissie	Boyce
Marjorie	Clemente
Goldina	Stephen
Cloe	Tuckie
Jessi	Townsend
Maurizia	Aguistin
Brianne	Klemens
Devon	Cleveland
Christin	Noe
Leigh	Dion
Aleta	Ange
Lizette	Codi
Talya	Patten
Darsey	Kimball
Joy	Shurlocke
Shanda	Rees
Lizbeth	Hillery
Kayla	Elnar
Vivi	Ignace
Filippa	Murry
Dianne	Ian
Lonee	Raleigh
Vi	Bondon
Demetris	Mar
Emiline	Yancey
Lauralee	Kristos
Annabela	Woodrow
Dix	Mendy
Eleanore	Sterling
Jeanette	Jessey
Nixie	Lock
Billy	Rick
Sherrie	Newton
Veronica	Renato
Mirelle	Jammal
Emelina	Nikolai
Glenda	Guido
Arlena	Sheffield
Caryn	Gare
Katina	Vernen
Keeley	Virge
Julieta	Barris
Alvira	Jeremy
Chickie	Aldus
Madelyn	Forster
Giulietta	Gerik
Josephine	Mar
Amalee	Tudor
Kerrill	Filmore
Jillana	Vlad
Marylou	Tanny
Charlean	Brooks
Jorry	Tedmund
Kore	Wally
Lucinda	Nikolai
Shelby	Codi
Cheryl	Wayne
Isis	Hashim
Wallie	Sydney
Janeen	Fritz
Bari	Peyter
Marigold	Ambrose
Lorita	Ernest
Albertine	Les
Kacey	Cart
Bette	Heriberto
Lin	Wilbur
Mirilla	Sheridan
Verla	Lock
Meris	Hilliard
Veradis	Cletis
Geneva	Graig
Corly	Arley
Stacia	Stewart
Bernardine	Barty
Evvie	Pieter
Renell	Art
Wrennie	Graham
Hanni	Alaric
Anne-Marie	Bern
Laure	Quintin
Arlen	Arv
Bonni	Levi
Francyne	Gray
Brett	Hagan
Emelina	Martainn
Yettie	Bren
Taffy	Derick
Nedi	Sholom
Cristen	Lazaro
Dyna	Egor
Carine	Mackenzie
Jori	Devland
Dannie	Felicio
Rene	Kerby
Dorris	Tuckie
Sheri	Bucky
Ranique	Binky
Thomasa	Gifford
Sybil	Brewer
Mellisent	Mahmud
Livvyy	Upton
Dodie	Hamlin
Vikky	Jeremy
Ashley	Benedict
Bunni	Desmund
Kippie	Lorrie
Hildegaard	Pattin
Sonnie	Nicolis
Daphna	Cass
Harmonia	Enrique
Vida	Diego
Kristel	Con
Lee	Quinlan
Irma	Artemas
Antonella	Karney
Sherilyn	Kenyon
Robina	Nikolaos
Ann-Marie	Nicol
Kassandra	Horst
Lilian	Grant
Florette	Mitchell
Vikki	Guillaume
Lona	Demetris
Rianon	Archibaldo
Page	Cullan
Mei	Flemming
Jeana	Maurizio
Jayme	Odie
Brooks	Edmon
Lisbeth	Nicolai
Dian	Abbey
Pietra	Guglielmo
Brina	Stillman
Dulcine	Rafaellle
Philippe	Gerrie
Dale	Jamil
Josselyn	Evered
Florri	Sigfrid
Philly	Granville
Therese	Dominic
Amitie	Noble
Teressa	Hayes
Courtney	Aguste
Hatti	Gasparo
Kendre	Alisander
Ninnetta	Jarred
Mab	Coleman
Eloisa	Courtney
Tammi	Tyrus
Vallie	Zack
Viki	Odell
Gwyneth	Emmit
Cherrita	Nickolas
Gwendolen	Welby
Julissa	Anatol
Dolorita	Olenolin
Cara	Jud
Lyndsie	Kevin
Marjorie	Harper
Blaire	Etienne
Bonnee	Charles
Mandie	Abelard
Riannon	Boycie
Odette	Willy
Caralie	Carlos
Seka	Fee
Gabrielle	Adolpho
Candra	Nicola
Elspeth	Grace
Cicely	Constantino
Deanna	Verge
Rosalia	Hogan
Shaylyn	Wynn
Dedra	Francois
Nettle	Clark
Crissy	Mervin
Ailene	Muhammad
Iseabal	Fletcher
Junia	Keane
Carlene	Kayne
Gerta	Fabien
Emogene	Stinky
Cecile	Hale
Caressa	Barny
Eda	Ashley
Jenica	Donny
Myrta	Sherlock
Stephannie	Wyatt
Carlina	Galen
Suki	Ezequiel
Loraine	Frederick
Miof Mela	Etienne
Dona	Siffre
Patrica	Verne
Devin	Brock
Xena	Jacky
Kamilah	Ferdie
Roseline	Spenser
Ki	Giffy
Karleen	Patty
Arlie	Ody
Jacquenetta	Devlen
Myra	Lauritz
Jeniece	Lou
Trude	Gearalt
Portia	Nevil
Garnet	Alix
Valry	Birch
Nadean	Fabien
Neille	Matthiew
Norma	See
Ronny	Jarib
Cassandra	Kenn
Vale	Elwyn
Darla	Nicolas
Aaren	Joachim
Fredi	Paquito
Lind	Ransom
Clary	Dick
Lily	Bern
Geneva	Lancelot
Cherey	Micheil
Dyana	North
Sadella	Brig
Aubrie	Neel
Aile	Chuck
Gena	Thibaut
Koral	Thoma
Agace	Maurits
Pamela	Zerk
Rubetta	Edan
Pat	Thorpe
Nanni	Welsh
Golda	Quinn
Jinny	Darrell
Dina	Gradey
Rhianon	Benny
Melisandra	Bowie
Liz	Allard
Raphaela	Elden
Pauline	Richmound
Tedra	Drew
Vivie	Ganny
Anabal	Way
Korrie	Erastus
Katerine	Gannon
Marjorie	Gerik
Aindrea	Gunther
Nicoli	Uriel
Shalne	Oby
Idelle	Riordan
Siobhan	Julius
Essie	Kenny
Mikaela	Saleem
Raphaela	Claiborne
Kimberlee	Richy
Jodee	Sebastian
Sybila	Carr
Libbi	Don
Lyndy	Rikki
Saloma	Burnaby
Filide	Rolland
Deerdre	Ulric
Michelle	Farley
Wrennie	Patten
Lorenza	Ari
Anderea	Selby
Aveline	Zach
Jerrine	Cornell
Suzi	Zach
Noelle	Jamey
Blanca	Mac
Jorry	Ignace
Gillie	Brett
Katrina	Tab
Stefanie	Urbanus
Jayne	Ambros
Quinn	Jud
Brittni	Dory
Clerissa	Weber
Ekaterina	Vin
Bettye	Shelden
Cass	Delmor
Sada	Teodoro
Nixie	Dean
Caril	Marcellus
Sophie	Vincents
Phedra	Zechariah
Phelia	Sonnie
Susannah	Winfield
Deborah	Ives
Marietta	Glynn
Celine	Matthiew
Tanitansy	Lon
Jaclin	Joseito
Marjory	Sidney
Nessa	Reinaldo
Jillian	Hanan
Yettie	Aubrey
Carree	Adler
Suzann	Clevie
Eleanora	Frederick
Adriana	Gino
Ludovika	Drew
Arleen	Yehudi
Kathryne	Derk
Tammi	Tull
Deloris	Jack
Gillie	Niels
Rey	Umberto
Josi	Silvester
Bessy	Haskell
Eustacia	Tibold
Deb	Josiah
Daisey	Gianni
Shelly	Graeme
Torey	Palmer
Sandi	Evelin
Shawn	Laurence
Helga	Orren
Ermina	Locke
Brittaney	Daron
Dionis	Nikolos
Devondra	Meir
Jordana	Julie
Rhodie	Gilbert
Nelle	Basile
Enriqueta	Caddric
Isahella	Alva
Jacquette	Wolfgang
Henrie	Mayor
Katey	Haskel
Thekla	Chauncey
Marlie	Brendan
Adria	Wilek
Marne	Baudoin
Neile	Harcourt
Daveen	Hardy
Orelle	Thurston
Veronique	Irvine
Lucie	Sarge
Drusi	Maximo
Ricki	Alistair
Allyson	Morse
Augustine	Boony
Ynez	Rolph
Shelagh	Jefferson
Marj	Felix
Cilka	Konrad
Gerry	Robbie
Kandy	Pincus
Ofella	Bordie
Louella	Hobart
Carrissa	Constantine
Debby	Gilles
Amalia	Dimitri
Elfrieda	Colby
Theo	Gaylor
Timmi	Abrahan
Hali	Baillie
Oralle	Paddie
Marjy	Timmie
Hillary	Edik
Teodora	Tiebout
Winny	Justino
Sharleen	Ingamar
Danell	Davidde
Carline	Si
Cacilia	Roderich
Alana	Bertram
Eolanda	Courtney
Cordula	Wallie
Tatiania	Donavon
Vonni	Richardo
Cynthea	Gustav
Raven	Reggis
Cristy	Ezri
Blaire	Barris
Carolyne	Angeli
Shane	Barry
Carlen	Nevil
Eba	Ross
Emma	Orson
Ellyn	Kennie
Jori	Jamal
Evita	Klemens
Mirabella	Parke
Denice	Marlo
Aryn	Lannie
Nancey	Agosto
Libbi	Sumner
Martelle	Derril
Mina	Joseito
Isidora	Sheffie
Cherri	Abrahan
Filide	Arman
Gunilla	Tally
Rebbecca	Hewe
Kacey	Taddeusz
Shelbi	Bax
Leland	Emile
Ertha	Brendis
Guglielma	Gan
Davida	Baily
Ginnifer	Jaime
Ellyn	Inness
Tawnya	Lothaire
Nikolia	Nikolos
Sena	Fitzgerald
Clovis	Donaugh
Gilbertina	Boyd
Rosella	Odell
Gavra	Far
Aileen	Lazaro
Kira	Christiano
Tiffani	Feliks
Sabina	Lodovico
Tammy	Valentijn
Taffy	Francisco
Anica	Arni
Maridel	Toiboid
Madelle	Burr
Alyss	Ximenes
Phyllida	Nevil
Brooks	Curtice
Sophi	Javier
Janie	Archy
Ardis	Ruprecht
Daisy	Drugi
Jacquenetta	Van
Luci	Asa
Odella	Vito
Faustine	Conan
Silvie	Burgess
Ines	Franklyn
Dulciana	Madison
Keelia	Troy
Rayna	Orton
Waneta	Isaiah
Datha	Sigfried
Yovonnda	Zedekiah
Athene	Kurt
Angil	Upton
Grace	Mathe
Harlie	Daven
Ally	Jacob
Christina	Pernell
Page	Nikolas
Evy	Johny
Cari	Herby
Karie	Freedman
Adeline	Godfree
Mair	Baudoin
Lorena	Carlin
Trista	Brody
Orsa	Bruno
Kira	Arny
Brigit	Hardy
Blinni	Jarrod
Zelma	Nowell
Jobyna	Ignacius
Marcellina	Justis
Kristi	Bjorn
Freida	Nilson
Ann-Marie	Clifford
Malvina	Beaufort
Letisha	Giff
Jesselyn	Linoel
Kizzie	Langsdon
Cathyleen	Lars
Tiphanie	Noland
Mead	Hobard
Theo	Donn
Ivett	Federico
Sarette	Osmond
Loralyn	Hersh
Kata	Burgess
Alanna	Ignatius
Cybill	Benson
Kendra	Erwin
Lissa	Caldwell
Rene	Thorin
Hollyanne	Bernhard
Tawsha	Ken
Gertrude	Lucas
Barbra	Rodrigo
Sydelle	Ara
Orella	Leicester
Vin	Willdon
Harriott	Edouard
Gavrielle	Reese
Jilli	Morie
Elianora	Orville
Britney	Timmie
Corenda	Remus
Roxie	Niccolo
Ethelda	Hersch
Arlene	Fairlie
Minetta	Jae
Adiana	Bordy
Jaquenetta	Adlai
Dotty	Ezequiel
Anabel	Farleigh
Junette	Kennett
Jackqueline	Erastus
Marilee	Thedrick
Nina	Alberto
Devan	Teddie
Danyette	Nat
Della	Basilius
Oliy	Cornie
Lesli	Carrol
Anjela	Bern
Judy	Ganny
Jaclin	Werner
Tracie	Pryce
Buffy	Caleb
Angie	Burl
Silvie	Skip
Robinett	Perry
Gertrudis	Horten
Leola	Troy
Crystal	Gallard
Doro	Mychal
Gusta	Harper
Gabrielle	Rodrick
Doreen	Levey
Jodie	Ilario
Sisile	Benjy
Marj	Guntar
Larisa	Hersch
Kally	Theodor
Nicole	Jorge
Toma	Jule
Ronnica	Axel
Matilda	Banky
Keslie	Sigismundo
Aimil	Austin
Kathye	Nils
Kristal	Tomaso
Darell	Marco
Katherina	Nero
Jordain	Hilario
Odilia	Yale
Gwenny	Jamesy
Maureene	Alric
Essie	Aland
Deena	Pattie
Norine	Gerri
Ferdinanda	Rip
Siusan	Ado
Donelle	Dylan
Larisa	Gregorio
Jobye	Kevan
Lisetta	Florian
Winna	Vince
Lorena	Otto
Shel	Johann
Jacquenetta	Carlyle
Auberta	Smitty
Jenda	Jermaine
Koo	Michal
Isadora	Smith
Minnie	Christos
Jaclin	Everett
Barbette	Griffin
Jenilee	Griffin
Merle	Alexio
Georgianne	Thane
Saundra	Minor
Astra	Aldrich
Kippie	Nicolis
Bridie	Karl
Nonie	Juan
Corissa	Torrance
Tamera	Killie
Jamie	Fielding
Zara	Saunder
Lanie	Jaimie
Karolina	Granger
Dorie	Milo
Maryjane	Frants
Salaidh	Kilian
Lolly	Christoffer
Zoe	Cornie
Reine	Mychal
Ilsa	Gian
Ilyssa	Zaccaria
Ferne	Xever
Jill	Ingram
Mignon	Alec
Jessika	Brander
Christin	Jedidiah
Jessika	Shae
Deeyn	Nickolaus
Buffy	Glen
Germain	Erek
Jamie	Harcourt
Madelyn	Rance
Candace	Lewes
Mandi	Vanya
Nedda	Sal
Melanie	Gregg
Brittni	Franciskus
Hester	Clement
Genia	Lemmy
Neilla	Sonny
Alma	Kinnie
Olivia	Lamont
Maurizia	Guglielmo
Willette	Elvin
Lexy	Erroll
Sheeree	Baldwin
Kristy	Claudianus
Thalia	Brenden
Doralin	Roma
Eleonora	Shurlock
Bertie	Gunar
Tobe	Spencer
Perrine	Jessie
Antonella	Tremain
Tybi	Sammy
Gwenette	Gregor
Cherri	Vladamir
Eve	Garner
Nadya	Boote
Jayme	Samuele
Inge	Angeli
Melli	Fowler
Lexine	Baxter
Devora	Steve
Gabbi	Rooney
Marrilee	Llewellyn
Loraine	Pavel
Gerry	Elnar
Winna	Ruggiero
Lavinia	Paco
Juline	Daryle
Hazel	Greg
Dix	Irwinn
Keely	Gifford
Lib	Clemente
Thomasina	Boot
Susannah	Shepherd
Mercedes	Hall
Consuelo	Judon
Lissy	Karel
Loralie	Wash
Leigh	Hendrik
Christi	Washington
Charlot	Alaster
Merla	Emmery
Benetta	Rees
Karlen	Eldon
Melissa	Newton
Anthe	Emmerich
Mareah	Shaine
Leone	Gaelan
Holly-Anne	Bealle
Ardenia	Lalo
Beitris	Bentlee
Celene	Yuri
Valentine	Pembroke
Gloria	Obediah
Margret	Hunt
Bunny	Solly
Zara	Teodor
Alyson	Lamond
Marcy	Stacy
Phil	Carlie
Gabrielle	Nolan
Salaidh	Tait
Petronia	Jule
Therese	Rochester
Ann-Marie	Leighton
Delinda	Gardie
Judi	Lauritz
Dorette	Kendell
Barbaraanne	Roland
Willy	Porter
Sheela	Ferguson
Katuscha	Ham
Carolyne	Vinny
Paulie	Base
Brynne	Lucian
Alvira	Chaddy
Nichole	Giles
Mady	Billy
Carola	Oswald
Lucienne	Eziechiele
Leonora	Ignacius
Leah	Eli
Carmela	Cullin
Arlinda	Wendel
Raven	Kelwin
Delila	Simeon
Devi	Silvanus
Germaine	Stanton
Aeriel	Vernor
Leia	Judas
Kai	Ford
Jacklin	Gary
Lilah	Alisander
Adriana	Tobe
Merrili	Bobby
Mona	Pat
Bernardina	Avrom
Joceline	Scotti
Arleta	Ly
Sada	Clare
Dorris	Mac
Aggy	Rowan
Maurine	Neron
Lorette	Quincey
Elianora	Orazio
Darlene	Edouard
Elinore	Marshal
Anthiathia	Byram
Mildred	Sully
Carroll	Prescott
Dianna	Edvard
Evangelin	Cornell
Nikoletta	Gottfried
Charlotta	Arthur
Sula	Warner
Micheline	Bearnard
Marja	Torin
Evanne	Syd
Eustacia	Delano
Beverley	Sanders
Milzie	Erik
Taffy	Giovanni
Frances	Curry
Kerstin	Edik
Phillie	Tris
Quintana	Cello
Helene	Alisander
Sabra	Orran
Florri	Zaccaria
Bessie	Zed
Lilias	Cary
Loreen	Terrance
Hildy	Ashlin
Ivy	Robin
Shaylyn	Romeo
Charmaine	Whitaker
Lenette	Adelbert
Mindy	Chilton
Lucia	Courtney
Lianne	Scarface
Larisa	Parnell
Bryn	Kippie
Jen	Dexter
Elena	Horatius
Shayne	Winfred
Barbey	Dru
Hanny	Haze
Agnes	Herrick
Morna	Kevon
Carin	Sander
Lara	Bordy
Etty	Tabbie
Fern	Barclay
Florella	Hamlen
Sallyanne	Adrian
Marissa	Emmett
Gloriane	Mikel
Stormi	Rocky
Kipp	Michail
Bekki	Orton
Terry	Benito
Marthena	Arnoldo
Corrinne	Stanislaw
Barbie	Flin
Tobi	Cleon
Mariana	Brice
Lou	Niles
Janella	Tam
Ada	Philip
Joanna	Corbet
Lynnette	Merry
Frieda	Francisco
Nadya	Wade
Diana	Sayer
Heidie	Puff
Ellyn	Bar
Heath	Waldon
Malena	Lamont
Mignonne	Cole
Amalea	Morse
Masha	Vaughn
Maria	Francesco
Philly	Upton
Patty	Wilhelm
June	Wesley
Natala	Goddart
Dulsea	Ariel
Rhodie	Carny
Sherill	Florian
Vinny	Flem
Gilligan	Jethro
Kris	Hubey
Hanny	Tab
Milly	Beauregard
Veda	Otis
Clarie	Tanny
Hanni	Stillman
Meridith	Kelwin
Linzy	Pedro
Cassi	Bartholomeus
Freddi	Kris
Dyanna	Yvor
Dolley	Rouvin
Raquel	Dominic
Beryle	Karl
Celie	Arnuad
Stevana	Rollo
Isa	Nick
Vilma	Oswald
Hana	Rodrique
Lotty	Elvin
Dena	Codie
Daveen	Dud
Agathe	Sancho
Ardeen	Meryl
Sabine	Jamal
Eulalie	Frederich
Jodie	Dallon
Jewell	Shaw
Violetta	Parsifal
Arlinda	Teodoro
Christina	Collin
Karry	Lin
Sharla	Marion
Robina	Garfield
Tersina	Cooper
Benny	Ingram
Quintina	Joe
Elsi	Roscoe
Gwen	Halsy
Shaylah	Buddie
Wynnie	Reagen
Lona	Elihu
Clarissa	John
Heddie	Roldan
Jandy	Rock
Lorraine	Romeo
Elise	Sim
Mia	Hew
Mady	Wyndham
Cecilla	Brant
Cicely	Templeton
Flss	Willy
Nicholle	Langston
Cathi	Georges
Arliene	Scottie
Kamilah	Freddie
Babb	Radcliffe
Kriste	Dunc
Natalee	Christoforo
Myrle	Jone
Sileas	Liam
Marin	Willard
Katharyn	Tobiah
Nancie	Rodrick
Melessa	Cullin
Dorolice	Corby
Gena	Nate
Deloria	Selby
Willyt	Christoforo
Kathy	Estevan
Keelia	Urbain
Diane	Merwin
Shandy	Esteban
Ivie	Haydon
Vivienne	Gannon
Corissa	Emmott
Tory	Cesaro
Eve	Pascal
Amaleta	Gabie
Valry	Chadwick
Melessa	Bastien
Karlee	Bordy
Devan	Nikolaos
Katlin	Hewie
Hulda	Branden
Mahalia	Renaldo
Jessika	Waldon
Vinnie	Carolus
Ainslie	Byrann
Sharla	Grace
Doti	Darnell
Nollie	Emelen
Anallese	Clim
Rycca	Aluin
Pamella	Joseito
Mariam	Mohandis
Cecilla	Krispin
Nevsa	Fonsie
Agatha	Mitchell
Jo-Anne	Hastie
Dorris	Yvon
Fiona	Armand
Joli	Mathias
Clarisse	Finlay
Malena	Ailbert
Lorianne	Heinrick
Almeria	Wit
Blanch	Saul
Mathilda	Durant
Carolann	Augustus
Merl	Gawen
Pammy	Thatcher
Beverlee	Wit
Ericka	Arel
Abby	Guy
Abbye	Chas
Britteny	Bradly
Mae	Kyle
Raine	Mattias
Marilyn	Dietrich
Clareta	Aymer
Cristi	Jakob
Siobhan	Herve
Herminia	Barnebas
Adele	Fransisco
Ericha	Jarrad
Ronalda	Alasteir
Mickie	Nikola
Moselle	Jerad
Jaquelin	Giffard
Codi	Isiahi
Pauletta	Doy
Darby	Fonzie
Felita	Orion
Esma	Enos
Leann	Brewer
Jeanna	Thibaut
Charmine	Glendon
Pauli	Milt
Jeniece	Pip
Polly	Bevon
Berri	Earlie
Ivie	Brand
Andee	Gaelan
Kristyn	Shannon
Tiphani	Conway
Carlynne	Whittaker
Darcey	Jens
Barbie	Hanan
Raven	Brook
Kym	Byrann
Dorie	Zack
Lulu	Mischa
Peta	Mel
Addi	Randie
Gayla	Eldredge
Lainey	Levi
Caritta	Emilio
Katinka	Kippar
Tasha	Merrick
Venus	Colman
Liza	Lindon
Andy	Carter
Anstice	Myles
Brianne	Berti
Bennie	Thorpe
Robenia	Kurtis
Tessi	Theobald
Meagan	Cecil
Lilla	Christoffer
Nanice	Rutter
Albertina	Justin
Delores	Gordy
Daveta	Blane
Rodina	Waylin
Carin	Carleton
Shantee	Claiborne
Stacie	Tirrell
Sean	Erastus
Melita	Samuel
Franni	Benn
Gelya	Ive
Paule	Alva
Danell	Jake
Esme	Olivier
Alfi	Bevon
Ibbie	Boycie
Marni	Jefferey
Wendi	Maddie
Madelene	Frasquito
Brianna	Maury
Franky	Georas
Julita	Bud
Elli	Norris
Demeter	Nealy
Concettina	Gerhard
Agnola	Brit
Pippy	Gottfried
Bari	Kinny
Corenda	Leland
Nerte	Herve
Ivonne	Fabe
Domini	Jayson
Latrina	Darby
Yoshiko	Far
Saidee	Herman
Riva	Wainwright
Tiffie	Humfried
Joanna	Rorke
Sari	Merrel
Isidora	Matteo
Dorrie	Mohandis
Emylee	Keelby
Lenora	Alic
Gerda	Umberto
Kitty	Rancell
Almeria	Kevon
Doralia	Boone
Lilian	Terrance
Sella	Chet
Elyn	Danie
Cariotta	Vick
Kordula	Dalston
Teodora	Chick
Lelah	Doyle
Alexandrina	Vladamir
Davita	Arel
Helen	Nickola
Mada	Paddie
Hermine	Web
Reina	Jesse
Shannon	Humfried
Shaylah	Jasper
Lizzy	Ethelbert
Sonya	Moises
Winonah	Conrade
Ladonna	Jamison
Anastasie	Broderic
Fredrika	Thedrick
Christalle	Horatio
Matilda	Tyrone
Ailyn	Toby
Ulrike	Jakie
Letitia	Tobie
Jere	Oliviero
Madalena	Aguie
Heidi	Will
Beatrice	Horten
Blythe	Tybalt
Drusilla	Marchall
Minna	Scotti
Emlynne	Stuart
Essie	Waldemar
Adoree	Skippy
Riannon	Gilburt
Kalinda	Ellsworth
Brianne	Levy
Julianne	Klaus
Isa	Delbert
Rhonda	Goober
Marinna	Feodor
Lily	Kendricks
Hilde	Iver
Elsa	Gordie
Darya	Noach
Leona	Alexander
Jeniffer	Felix
Moyra	Benn
Pattie	Shea
Alisa	Joseito
Alanah	Albert
Siouxie	Kerby
Alyda	Sherlock
Hedi	Chester
Abbe	Jody
Jasmina	Aymer
Carmen	Craig
Ki	Ephrem
Bibbie	Moore
Portia	Barnebas
Ketti	Penn
Ailis	Ruttger
Sheila	Waiter
Jeanine	Fons
Alis	Dean
Harrie	Yard
Cristin	Faber
Christel	Faber
Deb	Towny
Gates	Irwinn
Klara	Padgett
Lanita	Vick
Franky	Rey
Riki	Boone
Kalli	Wright
Giovanna	Duffie
Iolanthe	Lucius
Rivkah	Akim
Dorey	Smitty
Kristin	Osbourne
Sherill	Chaddie
Ruth	Linus
Julieta	Vladamir
Shandy	Packston
Fianna	Burlie
Kelci	Niko
Ellissa	Giacopo
Keriann	Perkin
Julee	Wilfred
Ibbie	Wakefield
Marijo	Dar
Trixi	Nicky
Maddie	Louie
Vivienne	Gil
Nydia	De Witt
Cynthea	Ollie
Gigi	Chip
Revkah	Les
Melony	Ermin
Dominica	Torrence
Truda	Lawton
Gwennie	Andonis
Dasi	Putnam
Stace	Allister
Randene	Mackenzie
Stephana	Geri
Glynda	Xever
Angele	Nickolaus
Marjie	Hayden
Ilka	Humfrey
Prue	Ollie
Rozele	Micah
Annora	Corbin
Rosetta	Ulises
Susann	Tadd
Josselyn	Hakim
Hertha	Hubie
Uta	Rorke
Mora	Kennan
Dinnie	Purcell
Alana	Konstantine
Guenevere	Zed
Clarinda	Shay
Cinnamon	Chadwick
Amara	Hinze
Krystal	Jase
Marjie	Alfie
Carly	Peterus
Fanchette	Court
Faye	Carr
Theodora	Milt
Rozamond	Mikey
Dorri	Michail
Margy	Rudyard
Shana	Bay
Barbey	Silvio
Kary	Abe
Faydra	Niccolo
Ryann	Florian
Tedra	Hilario
Corenda	Stewart
Amil	Bennett
Eunice	Claudian
Coriss	Gerri
Dorolisa	Vaughn
Emilie	Corrie
Willow	Rowland
Johnath	Albert
Amalita	Garvin
Chere	Averell
Anet	Boonie
Clementia	Crawford
Heather	Hanson
Claudina	Thom
Sandye	Timmie
Marinna	Niels
Christa	Ignazio
Jeni	Hartley
Dido	Udall
Georgetta	Geno
Alexis	Samuel
Jacinthe	Sammy
Kellyann	Esteban
Jillian	Reggis
Guglielma	Lem
Carlota	Corney
Gwendolen	Shaine
Ibby	Kort
Denice	Jay
Tomasine	Jamill
Lisa	Knox
Evonne	Lewes
Viviana	Ed
Fidelia	Dennis
Edyth	Granville
Verna	Archibold
Vonnie	Justin
Jessi	Alvin
Robinetta	Abbot
Phillis	Dalli
Dre	Arnaldo
Del	Wes
Cherri	Sherwood
Cymbre	Van
Roana	Maury
Wenonah	Thorndike
Benny	Murry
Serena	Tobin
Jolene	Vlad
Phaidra	Sandro
Rhonda	Vasili
Merlina	Ettore
Enid	Mathias
Cassaundra	Herman
Fiann	Andris
Deonne	Artair
Julienne	Flem
Isabelita	Trip
Blondell	Wilt
Donna	Peyton
Gilemette	Walton
Analise	Shay
Farrand	Angeli
Ryann	Parrnell
Marga	Sheff
Andree	Inigo
Lesly	Douglass
Celestina	Raymund
Tiffani	Francklin
Tess	Thedric
Trista	Avigdor
Karry	Jaye
Micki	Tyson
Gwenora	Yorke
Ronda	Cully
Hilda	Freemon
Rori	Sylvan
Florance	Lester
Sarena	Kayne
Sonia	Fernando
Tisha	Gallagher
Vina	Rudy
Clio	Ralph
Merrie	Heriberto
Loutitia	Reinald
Kipp	Upton
Zorina	Read
Cara	Haleigh
Ann	Flem
Phylis	Burt
Gusta	Lanie
Chrystal	Marius
Leigh	Early
Lezlie	Alaster
Dottie	Wallie
Reeva	Beale
Henrietta	Hermie
Merna	Renado
Jade	Sasha
Pandora	Monte
Frannie	Eddie
Louisette	Valdemar
Keslie	Cecil
Daffi	Natale
Jamima	Gunner
Avis	Giorgi
Consuela	Barthel
Josephina	Isiahi
Jena	Winn
Celesta	Kerwinn
Pearla	Alistair
Jade	Guthry
Cherish	Andonis
Shanna	Kellby
Jo Ann	Nikolai
Emalia	Mychal
Anica	Harold
Yevette	Iver
Cherey	Matthaeus
Kitti	Jules
Joleen	Coop
Liv	Mischa
Peria	Gideon
Margaretta	Derwin
Isabel	Christoph
Alisun	Griz
Alysia	Andris
Bobette	Adham
Koren	Witty
Liz	Hadrian
Maren	Donavon
Beatrix	Yorke
Angeline	Garvey
Julee	Abe
Maris	Norry
Glory	Iggy
Virgina	Riley
Gratia	Dewey
Tamra	Jeromy
Nadeen	Barde
Karlen	Izak
Malina	Albie
Kristien	Pascale
Dorene	Dario
Philly	Sheffy
Stevana	Terrance
Rachelle	Werner
Monika	Patrice
Dorine	Arte
Julietta	Elijah
Ainslie	Tobe
Suellen	Keary
Gaynor	Rickie
Joli	Garner
Agnella	Palm
Ruthe	Adler
Jemima	Mauricio
Alica	Benedick
Essa	Bax
Carolee	Irving
Jill	Berton
Fiorenze	Hilarius
Mersey	Trueman
Olympe	Greggory
Aimil	Steven
Dell	Caddric
Bunnie	Sonny
Lorne	Dunc
Hermine	Norman
Jaime	Felizio
Lindsay	Chev
Rory	Benji
Talyah	Bayard
Reba	Tanney
Tracey	Alberto
Lilas	Norman
Selena	Demetre
Gertruda	Horacio
Lizabeth	Andreas
Talya	Leon
Celie	Jonah
Bethany	Marc
Kamilah	Mikael
Clemmie	Farleigh
Yovonnda	Mord
Tabbi	Blaine
Mellie	Abraham
Anneliese	Thurstan
Leticia	Eddy
Gui	Griz
Rachelle	Eldin
Traci	Perry
Inna	Mano
Moyra	Kahlil
Christyna	Montgomery
Jeana	Rog
Jyoti	Leeland
Larine	Lem
Myrilla	Alden
Katey	Clint
Zia	Ennis
Lilas	Felipe
Cami	Morry
Constantina	Muhammad
Mikaela	Reynolds
Melessa	Brendin
Sheelagh	Paxon
Ernaline	Kincaid
Malynda	Emanuel
Shari	Thom
Nicola	Powell
Tammi	Paddy
Enid	Vaughan
Kala	Normy
Nertie	Bax
Myrtia	Theodor
Billi	Monte
Kiah	Lorant
Cherise	Byrom
Tawsha	Padraig
Rey	Trevor
Ashlan	Torrey
Roz	Gannie
Stormie	Ahmad
Cathie	Bendick
Jeniece	Chance
Sybilla	Tremain
Kiley	Timothee
Vittoria	Keefe
Opaline	Nicky
Sisile	Gerome
Trixy	Sheff
Kirsten	Johnathon
Cecily	Howie
Mirabelle	Lalo
Ami	Warde
Roselle	Brent
Marysa	Agosto
Sandra	Arthur
Dru	Fee
Casandra	Bartie
Dela	Shaine
Kara	Lew
Danni	Elbert
Bianca	Lionello
Shandra	Nealon
Eolande	Marvin
Malina	Dukey
Brita	Alfons
Frayda	Con
Shayne	Kendricks
Ericha	Tibold
Tony	Fraser
Lanie	Chucho
Tallulah	Ban
Ophelie	Raymund
Deny	Tan
Nollie	Harley
Bathsheba	Huberto
Agnella	Jere
Guinevere	Raul
Dorothy	Blair
Domini	Art
Vin	Giusto
Anestassia	Trefor
Elsa	Boone
Germana	Hugo
Latashia	Flemming
Cordie	Gregor
Aubrie	Jock
Michal	Muhammad
Florinda	Rawley
Susannah	Bob
Danyelle	Baryram
Leodora	Tome
Addy	Briant
Rodina	Dalton
Lynna	Zachary
Goldina	Marsh
Rhea	Donny
Roby	Cart
Jodie	Cole
Belva	Felizio
Tanitansy	Stanislaw
Jessa	Mic
Darice	Marchall
Sarine	Jessie
Amandy	Bar
Cherilynn	Will
Ellette	Gregor
Marianne	Pauly
Tony	Goddard
Bessie	Nate
Shandra	Efren
Shari	Cortie
Marylinda	Laney
Dorry	Darren
Erma	Gian
Faun	Zerk
Karalynn	Tallie
Agnola	Goraud
Milissent	Howie
Dot	Alvis
Vivianna	Vaughan
Garnette	Mahmoud
Sybilla	Jorge
Alysia	Leonerd
Siana	Frazer
Melody	Gram
Arabella	Dun
Monah	Ned
Phyllys	Ford
Jacquelin	Minor
Federica	Beaufort
Nevsa	Dew
Noelle	Donalt
Bunnie	Jehu
Angelita	Jens
Joli	Monroe
Fred	Kendal
Bidget	Chaunce
Raphaela	Clint
Rosy	Erick
Dotti	Derek
Leisha	Gustave
Lacey	Eugenius
Ermengarde	Caddric
Lotte	Travus
Cristin	Ralf
Jody	Norbie
Evvy	Berk
Kizzee	Lance
Rowe	Francois
Patrica	Christoph
Faydra	Pablo
Milzie	Alwyn
Grier	Skyler
Rica	Carl
Velma	Parker
Elie	Sigfrid
Michelina	Gene
Jacquelin	Keelby
Marybeth	Mathew
Samaria	Kenyon
Marna	Chucho
Lorelei	Wang
Bernette	Hillary
Sofia	Gage
Helga	Slade
Gerrilee	Seth
Giralda	Jameson
Gabriel	Tobe
Debora	Myer
Stephani	Leonidas
Bel	Tracy
Noemi	Noak
Sibelle	Roderic
Hermione	Sidnee
Friederike	Waylan
Genny	Colan
Athena	Padriac
Brigitte	Daryl
Dorelia	Kaleb
Malissia	Lewie
Enrika	Gradeigh
Kellen	Lock
Gretta	Rutter
Beckie	Jordan
Mel	Aron
Cherry	Goddart
Gayle	Alford
Devon	Field
Vittoria	Matteo
Jacquetta	Hakim
Ellen	Darius
Moyra	Waite
Lorette	Ermanno
Cherish	Feodor
Tamarra	Kaine
Nelli	Donnie
Debi	Valentin
Jesse	Chandler
Tabby	Ev
Rochella	Homere
Leila	Farleigh
Josee	Burr
Aggi	Antone
Calley	Gonzales
Arabella	Robers
Jerrilee	Stanford
Rozalie	Sydney
Glynnis	Silas
Nancie	Anatollo
Daveta	Freeman
Gilbertina	Tremain
Ninon	Leland
Alli	Marius
Maryl	Pattie
Celesta	Pancho
Jenna	Harland
Lona	Dagny
Ray	Nickolai
Crystie	Gris
Happy	Jack
Loria	Clark
Nellie	Bert
Doralynn	Phillipp
Karon	Dorey
Kalli	Christophorus
Nissie	Archibald
Glenna	D'Arcy
Estelle	Samson
Arielle	Heall
Robinetta	Izzy
Hermia	Marcello
Evangelina	Matty
Lind	Emilio
Jennee	Anders
Holly	Sanderson
Leann	Corby
Willy	Garrot
Jessamyn	Pryce
Barbra	Elijah
Rosmunda	Martyn
Carrissa	Ernest
Phil	Leonard
Clary	Armstrong
Bernadette	Filbert
Easter	Tadeo
Phyllys	Orazio
Gladys	Ashby
Mella	Willem
Lorianna	Burk
Maureene	Lucius
Genia	Darrel
Halli	Yank
Lucine	Marius
Deva	Roderigo
Renelle	Rey
Ardine	Maje
Chastity	Chevalier
Sherie	Mychal
Portia	Quinlan
Ally	Lukas
Talya	Alain
Vevay	Irv
Estele	Ferdy
Sasha	Guthrie
Cosette	Sid
Ursa	Ciro
Celle	Dimitry
Eustacia	Bryon
Lorelei	Antoni
Elinore	Pasquale
Amalle	Phil
Veronique	Rand
Brenn	Michel
Minni	Keenan
Zondra	Nestor
Jammie	Anson
Adora	Romeo
Sallee	Dov
Honey	Trstram
Annabell	Ian
Clari	Thorsten
Tommy	Corby
Guglielma	Merell
Letizia	Rodger
Katuscha	Ward
Ulrica	Malcolm
Dulcie	Johann
Kellina	Budd
Sib	Lyle
Truda	Webb
Mercedes	Sidnee
Shanna	Kerr
Janella	Boote
Elfrieda	Salvatore
Lilla	Efrem
Alameda	Gardener
Winna	Kinsley
Guenna	Billy
Ninon	Caddric
Leah	Humfrid
Chiarra	Ugo
Ulrikaumeko	Arther
Aloise	Kipp
Geraldine	Balduin
Fawne	Nikos
Laraine	Harwilll
Austina	Bronnie
Charmion	Marco
Paige	Sergeant
Gertrude	Shayne
Karoly	Ian
Netti	Elmore
Ninnette	Ky
Doreen	Worthington
Cammi	Justino
Julianna	Stephen
Basia	Corby
Kassi	Brendin
Leontyne	Thayne
Jamima	Amery
Ericka	Alexandre
Bobbee	Miguel
Andreana	Ring
Ina	Yorker
Karen	Lewiss
Elsinore	Bjorn
Malory	Aleksandr
Moreen	Damien
Emlynne	Tibold
Ardenia	Con
Pen	Morgun
Estella	Angelico
Shannah	Alexander
Missy	Sterling
Ginni	Cob
Bibi	Tuck
Kizzie	Goran
Micheline	Bartolemo
Bryana	Kit
Angele	John
Gayleen	Ezri
Eden	Davidde
Kalina	Lodovico
Sybille	Randal
Morgana	Rutherford
Kath	Engelbert
Kristen	Zared
Hyacinthie	Wye
Kaitlyn	Laughton
Violante	Quent
Carmencita	Wainwright
Hestia	Thacher
Angeline	Traver
Ermentrude	Jackson
Toby	Adrian
Norine	Paige
Cissiee	Georg
Karmen	Orazio
Jaclyn	Maxy
Rachael	Laurence
Kerri	Paddie
Cherilynn	Bondie
Mitzi	Tomkin
Eva	Laurence
Ardys	Burt
Anthia	Aldin
Melodie	Reinold
Mimi	Romain
Mignon	Eldin
Enrichetta	Martie
Dannie	Humberto
Ronna	Ernesto
Nathalie	Forster
Romonda	Isador
Claresta	Caldwell
Leandra	Tony
Gertie	Orazio
Teri	Antonius
Jordan	Malcolm
Maxi	Constantine
Jobey	Finley
Marj	Wayne
Stacie	Windham
Kaitlin	Seumas
Emelyne	Knox
Eliza	Lenci
Michelina	Klaus
Prisca	Karim
Evania	Renaldo
Margalit	Levon
Ilene	Harland
Merridie	Dwain
Tish	Alden
Isahella	Elias
Ailee	Mannie
Shalna	Melvyn
Nadeen	Courtnay
Reena	Thibaud
Antonie	Vinny
Agnes	Wallace
Cristabel	Elmore
Perle	Rex
Harrie	Osbourn
Melosa	Mikkel
Jenilee	Harland
Amitie	Flint
Ava	Frans
Erminie	Harlen
Nadine	Derrick
Emmye	Oates
Gena	Hoyt
Emma	Willis
Alayne	Uriel
Kelsey	Vito
Mabel	Casper
Felipa	Hyman
Cinnamon	Rodge
Fanchette	Barr
Sharleen	Porter
Cinnamon	Doy
Marena	Shem
Gratia	Raul
Babb	Nickie
Sisile	Frasquito
Britteny	Brennen
Meryl	Derrick
Auria	Byron
Ricky	Wiley
Erina	Benjamin
Emelda	Wyn
Larine	Tynan
Guillema	Luke
Cleopatra	Omar
Flore	Braden
Cecilia	Aldwin
Anna	Clemente
Catriona	Brnaby
Collette	Fielding
Kylen	Jaimie
Barbara-Anne	Clair
Constanta	Michael
Amara	Milo
Maddie	Rancell
Tomi	D'Arcy
Rozamond	Jimmy
Laurianne	Kenn
Krysta	Osbert
Ann-Marie	Garvin
Dominique	Terrell
Britney	Scott
Kipp	Berke
Doralia	Fredek
Annelise	Ike
Waneta	Niel
Carline	Heath
Jeniece	Richardo
Melessa	Spense
Maudie	Jermaine
Ruthe	Desmund
Letty	Mikel
Delia	Samuel
Leonora	Garth
Stesha	Carny
Priscella	Sloane
Kariotta	Niki
Bianka	Jason
Melisse	Mendy
Junette	Avery
Carol	Peder
Sacha	Stillmann
Claudetta	Odo
Kristen	Daren
Jillian	Fritz
Sonja	Uriah
Hollie	Bernhard
Jacquelyn	Richardo
Brandy	Alessandro
Mirilla	Olin
Isahella	Baudoin
Neysa	Nobe
Jobey	Bartlett
Imelda	Sax
Diandra	Shell
Allyce	Sergio
Hanny	Crichton
Margalo	Westley
Ida	Manuel
Lindsay	Chrisy
Phyllys	Pembroke
Marje	Renaud
Maribel	Mead
Carley	Brnaba
Rhoda	Shea
Alisun	Regen
Aindrea	Micheil
Moyna	Edsel
Loralee	Perren
Brandie	Zared
Christie	Hussein
Amalle	Temple
Marje	King
Edie	Webb
Zonnya	Lance
Willi	Gus
Tine	Giraldo
Carlye	Bronson
Auberta	Standford
Kaila	Dunn
Arlinda	Darwin
Cherise	Somerset
Shayla	Magnum
Linzy	Tedd
Angelia	Max
Rosamond	Avigdor
Julienne	Hilary
Donica	Garvey
Hilda	Lorenzo
Cathi	Morgen
Corette	Darwin
Gusty	Sim
Elmira	Ingrim
Christal	Micheil
Martguerita	Vincent
Linell	Salvador
Atalanta	Alistair
Leesa	Inger
Carlina	Gabriele
Roselia	Ulises
Belicia	Elroy
Celestyn	Richart
Lanni	Ring
Maurene	Red
Philipa	Ezekiel
Belicia	Arnuad
Maisey	Alisander
Rafaela	Clemmie
Mufinella	Pete
Audra	Othello
Selena	Berkie
Cristionna	Giffard
Arda	Verge
Bari	Lukas
Wynny	Hy
Ardene	Serge
Candra	Remington
Dre	Blayne
Cyb	Boonie
Auberta	Umberto
Camila	Ansell
Beryle	Cheston
Gillan	Darcy
Elsa	Travis
Gayle	Rudolfo
Melina	Thurstan
Corie	Isa
Denny	Bartolemo
Waneta	Colan
Belinda	John
Terese	Hershel
Laurie	Avram
Heda	Hadleigh
Geneva	Teodor
Cherie	Vincents
Nancie	Boyd
Melania	Phillipe
Maible	Virgie
Audre	Meade
Madelena	Ivor
Paige	Eal
Norene	Rollie
Fredi	Rolf
Annamarie	Myrvyn
Deedee	Gustave
Joela	Osbert
Barrie	Zedekiah
Hildy	Johann
Rhiamon	Ahmed
Trixie	Myer
Yoshi	Giovanni
Agace	Enos
Lillian	Esme
Marilee	Norby
Carissa	Virge
Savina	Shalom
Jackqueline	Brook
Guendolen	Simone
Gretel	Morly
Courtenay	Vidovic
Orsola	Enoch
Tierney	Kilian
Lanette	Vincenty
Moira	Kalle
Rubetta	Guthrey
Micky	Parry
Norah	Evin
Gusella	Mattie
Etheline	Ethan
Aubrette	Bruce
Maxi	Davon
Marguerite	Justen
Cammi	Lind
Celestine	Menard
Dorita	Cornie
Melania	Fritz
Emmye	Putnem
Anjanette	Charley
Norah	Ibrahim
Maggie	Prescott
Devina	Andrea
Marinna	Agosto
Roseline	Malvin
Jess	Dilly
Linnet	Baudoin
Odessa	Esdras
Nissie	Hillary
Kay	Vito
Jamie	Justus
Dominica	Alford
Illa	Case
Maddi	Zane
Ninnette	Tammy
Ninette	Crosby
Leah	Murry
Fawn	Malvin
Briana	Clifford
Oralee	Raffarty
Antonietta	Ikey
Erika	Rustie
Kamila	Reuben
Dede	Merrick
Helge	Micky
Anastasie	Irwinn
Cathrine	Dewitt
Marylou	Bret
Jenda	Lewiss
Tabitha	Angeli
Shandeigh	Adriano
Tatiana	Randie
Kirbie	Russell
Daniele	Quentin
Amalle	Darius
Robyn	Eal
Lyndsey	Skell
Imelda	Clywd
Korry	Alexandr
Gillie	Nels
Shaylynn	Jeramey
Melodie	Bradan
Pippa	Timothy
Melisenda	Ase
Sabine	Car
Cissy	Chas
Bonni	Cornall
Karil	Merrill
Arliene	Blaine
Jodi	Gannon
Neysa	Basil
Deidre	Talbot
Rosamund	Jo
Gilligan	Salvatore
Anallese	Ritchie
Sib	Pavel
Lee	Saw
Amargo	Alan
Karalynn	Reidar
Patty	Jamesy
Philomena	Ware
Ramonda	Trey
Gilli	Benny
Glennis	Britt
Letty	Israel
Jilli	Randolf
Misti	Michail
Judy	Broderic
Johna	Taber
Patrizia	Ker
Damaris	Ragnar
Lucine	Ikey
Vera	Zerk
Kerri	Guilbert
Alexis	Kelsey
Marris	Tome
Meta	Palmer
Kitti	Hermann
Masha	Baldwin
Dre	Tommy
Muriel	Marlon
Lauri	Yale
Lucia	Zach
Reine	Giuseppe
Georgianna	Marc
June	Keven
Annice	Phillipe
Neille	Barrett
Nat	Morly
Nicoline	Temp
Berry	Sarge
Malia	Ruttger
Adria	Finn
Shirlee	Xymenes
Jorie	Lindsay
Kameko	Stephan
Joline	Valentin
Merilee	Sheridan
Rosalyn	Conrad
Ginelle	Con
Rayshell	Land
Kitty	Theobald
Blithe	Klemens
Xena	Emmit
Pattie	Norrie
Valerye	Dani
Adrian	Horten
Em	Jared
Veronique	Huntlee
Dalila	Eldon
Cherye	Jake
Andreana	Aguie
Roobbie	Mychal
Virgina	Wendall
Ellette	Kerwinn
Adriane	Hobey
Ramona	Bryan
Florette	Price
Charmine	Nikki
Kacie	Eldridge
Alissa	Khalil
Anissa	Keene
Kellen	Tobe
Leola	Carlie
Salli	Foss
Rochella	Andrea
Suzy	Ruby
Goldie	Antin
Sharlene	Roscoe
Austine	Humfrid
Debby	Dermot
Lian	Daryl
Amity	Zedekiah
Cayla	Yuma
Sandi	Gaultiero
Kelcie	Roderigo
Elane	Holly
Catlin	Christiano
Charmane	Filippo
Susie	Basilius
Tildi	Sandro
Luella	Griff
Chandra	Erek
Angil	Christiano
Franny	Roth
Tine	Moise
Dorotea	Irwin
Regan	Serge
Jo-Ann	Bobbie
Alice	Yul
Chandal	Andrej
Cicely	Ring
Reta	Worthy
Fanchette	Stanfield
Mavis	Gan
Ginny	Tirrell
Jacinda	Meredith
Cicely	Sandor
Tine	Case
Gabey	Lonny
Corey	Ange
Mariam	Sloan
Kimbra	Olivier
Darcey	Sherlocke
Allx	Hiram
Roxana	Conrade
Jacklin	Homer
Evania	Maurice
Nerissa	Thornie
Jilli	Jackson
Sharona	Carney
Vallie	Eberhard
Dayle	Emmett
Ivonne	Jarad
Arlene	Chrissy
Ezmeralda	Myer
Rahel	Jerome
Karry	Sayres
Reeta	Jude
Adrienne	Fairleigh
Lanni	Leonerd
Tabbatha	Stanislaw
Kelci	Gerry
Pauline	Hercules
Tiffie	Cassie
Darline	Dagny
Deedee	Federico
Kassi	Leon
Faun	Zachery
Shandy	Sonny
Tessa	Sheffy
Rosemarie	Reade
Elianore	Jodie
Roseanne	Buddie
Nydia	Adamo
Barbabra	Chris
Chiarra	Linus
Leslie	Abrahan
Konstanze	Hughie
Dody	Grace
Marjorie	Gibb
Doralyn	Berk
Dorthy	Arel
Ailsun	Maxy
Ianthe	Paten
Kelcy	Piggy
Amata	Reinold
Lizbeth	Delaney
Clerissa	Conrade
Junette	Jeramie
Felipa	Dolph
Celka	Ludovico
Jacquetta	Hill
Ernaline	Robinson
Ellyn	Jacob
Marcella	Ruben
Sal	Mike
Bibbie	Morrie
Lia	Eli
Hedda	Boyce
Con	Franklyn
Portia	Tyson
Annabel	Kerby
Trudi	Artemis
Jemima	Sheppard
Joelie	Bat
Evita	Derward
Ferdinande	Gherardo
Eolanda	Osbert
Dinah	Wells
Pen	Marlon
Valerie	Graehme
Mariejeanne	Erasmus
Fernanda	Archie
Daphne	Chad
Chanda	Bobby
Tandie	Cello
Kayla	Gamaliel
Bidget	Roosevelt
Lillis	Neal
Jo	Shay
Siusan	Rowland
Bridget	Pepito
Krystyna	Bary
Jacqueline	Connie
Shalne	Kaspar
Miguela	Aldon
Cyndie	Augustin
Jeanette	Herrick
Mariya	Gunar
Lynnea	Barty
Clementina	Vito
Mariya	Barrett
Nancie	Alphonso
Zahara	Wit
Jillayne	Jamie
Samara	Britt
Afton	Barnabas
Gustie	Haslett
Lynnea	Ansel
Mirabella	Selby
Carlynn	Westbrooke
Ebony	Kimball
Odille	Kingsley
Annalee	Leslie
Karolina	Barrie
Faunie	Earle
Daron	Darill
Tine	Karim
Joelynn	Benjamen
Molli	Barton
Christa	Matthieu
Ettie	Antonio
Ros	Dionysus
Colline	Jarret
Gratia	Adham
Vernice	Wynn
Vivianne	Ozzie
Rycca	Niki
Pippy	Talbert
Fifi	Alfy
Eda	Fabio
Berta	Reider
Sisely	Jecho
Blondell	Adam
Tommi	Zane
Tamar	Zacharia
Siana	Tyrone
Jemima	Bobby
Lorilyn	Webster
Lil	Maynord
Anastassia	Benedetto
Alecia	Silvanus
Sonni	Jeffie
Muire	Sigfrid
Lauryn	Willi
Sorcha	Harvey
Darla	Mendy
Ediva	Wyatt
Maridel	Guthrey
Cathee	Perkin
Eleonore	Darrin
Ginger	Clare
Annalise	Maurise
Corny	Jephthah
Eda	Salvidor
Aarika	Lewiss
Frieda	Mateo
Devonne	Cyril
Doreen	Wiatt
Melissa	Weylin
Jocelyne	Keenan
Brandi	Terrill
Seka	Dwight
Sheri	Barclay
Margaretha	Madison
Almeria	Norris
Druci	Hagan
Cosette	Hillard
Betty	Dalli
Dottie	Linc
Misti	Peyton
Myra	Cullin
Fayth	Nichols
Tisha	Hort
Charleen	Bartel
Gabi	Bondie
Ranice	Merry
Melodie	Lee
Calla	Gonzalo
Malorie	Karlan
Kellie	Prescott
Randee	Felicio
Tisha	Sammy
Timothea	Korey
Bunnie	Westley
Joey	Dimitry
Magdalen	Patrick
Allie	Mattias
Romy	Tymothy
Rosita	Phillip
Sherie	Gaultiero
Katlin	Scarface
Dorice	Drake
Bliss	Dieter
Ainslie	Michail
Bernete	Pennie
Frederica	Yale
Orella	Vincenty
Clemence	Gilles
Chantal	Langsdon
Abbey	Isador
Isidora	Franky
Mandie	Preston
Krissy	Winfield
Basia	Alon
Mariska	Tobie
Kamila	Maurice
Viv	Hastings
Carol	Damian
Barbabra	Rob
Rora	Parnell
Sybila	Saundra
Selene	Craggie
Sydney	Tobe
Alysia	Merv
Jenelle	Leo
Cacilia	Chicky
Vonnie	Bartolemo
Dot	Brnaba
Doloritas	Ruprecht
Corabella	Ray
Merl	Blane
Hannie	Ingmar
Dorthea	Hazel
Tiphany	Brucie
Harmonia	Towney
Sharona	Sauncho
Roselle	Garwood
Brina	Corey
Lanie	Marvin
Elora	Lucio
Anastasia	Montague
Natalya	Jamey
Fleur	Waring
Chiquia	Nikolai
Reeta	Willi
Antonella	Buiron
Winni	Manuel
Goldy	Saw
Charline	Allayne
Koralle	Sigmund
Eddi	Fin
Fania	Troy
Dyan	Ezra
Fionnula	Hernando
Caroljean	Lars
Michelina	Kilian
Vevay	Bengt
Afton	Waylan
Myra	Chaddy
Charmion	Magnum
Gavrielle	Matthew
Merry	Delainey
Ethelind	Alain
Theodosia	Bryon
Elyse	Benyamin
Adi	Kermit
Charmian	Godart
Gabriellia	Aland
Avril	Morton
Lila	Murdoch
Clementia	Gerhardt
Camila	Lorin
Bennie	Hayward
Vinnie	Neel
Zenia	Brand
Brianna	Wain
Pepi	Cole
Kellyann	Lowrance
Dallas	Tanney
Emelda	Karim
Edythe	Anton
Ginnifer	Ichabod
Charmian	Kinsley
Tiphanie	Pablo
Lenka	Ruddy
Florenza	Bale
Crysta	Algernon
Ray	Lukas
Koralle	Merle
Nikolia	Duffy
Bessie	Butch
Rosette	Herby
Katlin	Colet
Lyndy	Barrett
Melitta	Pyotr
Rosalinde	Engelbert
Ania	Dennie
Vallie	Sanderson
Brena	Gianni
Malena	Thorsten
Luelle	Rafferty
Evy	Rodger
Adriena	Karl
Lauryn	Douglas
Helga	Trueman
Leah	Rhett
Roobbie	Win
Yetty	Sergio
Darleen	Sherwood
Dore	Vernen
Mady	Cobbie
Ashil	Cozmo
Lucilia	Urbanus
Kristel	Alasdair
Charmion	Michael
Andriette	Rinaldo
Karol	Payton
Hendrika	Darrin
Malena	Alyosha
Miriam	Reynolds
Joann	Regan
Betteann	Gottfried
Sile	Isak
Ariel	Barthel
Jennilee	Brewster
Layne	Leigh
Teresina	Connor
Alfie	Denver
Roshelle	Quent
Charlena	Desmund
Karita	Miles
Arleyne	Grove
Eada	Terrance
Andi	Alphard
Phyllida	Ham
Dorene	William
Vonni	Kristopher
Florida	Bald
Nerta	Goddart
Aggi	Valdemar
Francene	Payton
Malina	Derk
Ashley	Vinnie
June	Chrisy
Sybila	Orazio
Sheila	Kenn
Susie	Arri
Cherlyn	Benjie
Miguela	Clevey
Lucine	Bartlett
Sonya	Hollis
Harmonie	Tiebold
Dynah	Vincenz
Christie	Barret
Myranda	Gustaf
Genny	Reinold
Luelle	Wyatt
Allis	Chickie
Estelle	Maxy
Legra	Emmanuel
Ninette	Vassily
Debi	Gun
Debbie	Jean
Daisi	Clim
Moyra	Kenny
Darb	Hershel
Ardath	Herschel
Janette	Dur
Rochette	Karim
Whitney	Bendicty
Shana	Carroll
Enriqueta	Shem
Betty	Luca
Annissa	Sherlock
Elvina	Robb
Alfie	Jourdain
Etty	Algernon
Allina	Morton
Ray	Levin
Ethyl	Enoch
Lotta	Donnie
Ekaterina	Sinclare
Jeni	Mord
Krysta	Samuele
Hortensia	Wash
Tilda	Darrin
Kevina	Alard
Fidela	Nealson
Keely	Dun
Ruthi	Benton
Damita	Kent
Annecorinne	Vernon
Merrill	Sonny
Teresa	Land
Tandi	Elton
Erda	Leonardo
Brynna	Millard
Maddi	Lockwood
Ramonda	Hanan
Rina	Chaddie
Valma	Hersch
Danny	Daren
Debi	Haily
Rachael	Wheeler
Stephi	Esdras
Clarinda	Shelley
Lindie	Odell
Aryn	Vernon
Johnette	Cornelius
Willamina	Howey
Vikki	Cliff
Ardisj	Sauveur
Iolande	Titos
Martina	Hillie
Carla	Chance
Heloise	Mick
Mariquilla	Gibb
Magdalen	Muhammad
Zuzana	Patton
Tammy	Rodolfo
Aurelia	Emanuele
Rosalie	Vanya
Danit	Teodoro
Trix	Stavro
Didi	Silas
Eula	Duffy
Sarette	Bard
Mattie	Cull
Lorinda	Garv
Celle	Armstrong
Dasi	Orbadiah
Gabrielle	Abran
Eudora	Huberto
Trish	Haleigh
Fey	Artus
Roxane	Terry
Garnet	Leopold
Evy	Vaughan
Datha	Stanly
Pauly	Reynolds
Hayley	Tully
Ebony	Ricard
Loria	Alric
Britney	Duffy
Emlynne	Gil
Codi	Quintin
Agnesse	Patrizio
Nalani	Alasteir
Mirilla	Arron
Cristi	Bryn
Nora	Berty
Dela	Jeremiah
Gretchen	Brett
Joela	Mord
Crissie	Vic
Bell	Isadore
Cassie	Benedick
Kimberly	Iver
Morissa	Roosevelt
Abigale	Jeffie
Lesli	Marvin
Rubetta	Frasier
Dede	Silvio
Dasi	Far
Mercie	Harvey
Celestia	Kristopher
Anestassia	Arnuad
Mechelle	Oliviero
Luce	Kyle
Rebekkah	Artemis
Geraldine	Ambrosi
Mollie	Lucius
Stoddard	Worthington
Cassondra	Mord
Minta	Hasheem
Charyl	Lucio
Anestassia	Ailbert
Josefa	Geno
Gayla	Merell
Konstanze	Zackariah
Chlo	Ely
Sashenka	Eduino
Violetta	Buiron
Cordula	Humfried
Mavis	Shayne
Alyse	Solomon
Thomasina	Brodie
Jonie	Hermann
Tani	Mikel
Deirdre	Cristobal
Ralina	Wittie
Sherilyn	ErvIn
Jobi	Marijn
Vonni	Bram
Tansy	Abel
Gratiana	Quincy
Cathi	Frederick
Hesther	Jim
Meridith	Kin
Rosette	Vachel
Cassandre	Averil
Kellen	Mendy
Crissy	Francesco
Tarah	Niko
Amelie	Jerad
Camilla	Mile
Brear	Ogden
Chandal	Poul
Robinette	Axe
Portia	Roddie
Katie	Allie
Beth	Mycah
Susanne	Tannie
Sunny	Neill
Anthea	Chariot
Ariadne	Dieter
Cory	Donaugh
Cordelia	Parsifal
Caroljean	Benedikt
Rozelle	Forrester
Viviyan	Wildon
Tatum	Brnaba
Wileen	Hollis
Elinore	Eric
Tybi	Harvey
Nerita	Ellis
Nicolina	Weston
Kristan	Vail
Aila	Bruce
Sondra	Ferdinand
Marin	Hugh
Catrina	Ferd
Bellina	Benedetto
Lorilee	Lyell
Aundrea	Gilberto
Darla	Murry
Grethel	Yvor
Shaun	Gene
Caye	Mart
Rosemonde	Roddy
Arlina	Ced
Beverie	Valentijn
Giustina	Kane
Jolee	Hart
Devondra	Hillard
Kerry	Berkley
Mil	Meade
Robinette	Abby
Harmonie	Olin
Corry	Dimitry
Calli	Sherwynd
Vivi	Cris
Yoko	Charlton
Cherry	Seamus
Dorene	Nial
Ermengarde	Jory
Linn	Reagan
Mercy	Martainn
Lydie	Barnie
Venus	Jacob
Dael	Son
Emalia	Teador
Cristabel	Greggory
Harrie	Franny
Theo	Elston
Violette	Thibaud
Grazia	Lydon
Harmony	D'Arcy
Jolynn	Wheeler
Bree	Boris
Eddi	Goddard
Nelli	Rand
Helge	Wyatt
Giana	Mead
Ronica	Abe
Meryl	Wilden
Jackelyn	Roman
Lavinie	Christoph
Nike	Ring
Erinna	Wat
Donna	Ephrem
Chelsea	Lindsey
Crissy	Eldridge
Leodora	Everett
Pammie	Kennett
Charil	Claybourne
Alma	Padgett
Minne	Ashlin
Roselin	Packston
Aloysia	Bendicty
Erena	Gorden
Mella	Germayne
Lizbeth	Regan
Beryle	Biron
Dena	Mace
Wilmette	Reggy
Olly	Sonny
Marline	Silvio
Gypsy	Lars
Neely	Cos
Farica	Zane
Annadiana	Burlie
Floris	Vlad
Chantal	Bryan
Sheena	Myca
Randa	Shaine
Jacquette	Geoff
Krissie	Morley
Sosanna	Tomas
Quinta	Brandy
Chiquita	Rafaellle
Ginger	Wade
Deni	Kenn
Alejandra	Sigvard
Ermina	Griffin
Michaela	Pietrek
Isahella	Jasen
Lulita	Rice
Allyson	Taber
Daniela	Wald
Glynis	Fredrick
Laina	Evan
Dena	Obediah
Iona	Clayborn
Annalise	Kerby
Easter	Vernor
Raina	Claiborne
Kimberlyn	Franz
Esmaria	Norry
Jennine	Pearce
Theresa	Scotty
Nicky	Otto
Deana	Hyman
Starla	Yul
Debora	Gauthier
Martita	Osbourn
Ardelle	Leeland
Ettie	Mattheus
Nariko	Mack
Arlette	Arlen
Letisha	Terry
Stephi	Klemens
Elfrida	Dexter
Norry	Wyatt
Sophia	Hammad
Caitrin	Harland
Chanda	Ambrosi
Amalea	Dolf
Barrie	Humfried
Annetta	Forbes
Cammy	Ganny
Ophelie	Had
Etti	Westbrooke
Fredia	Grover
Flory	Lenci
Sophronia	Bancroft
Danika	Pace
Orsa	Richy
Dusty	Doug
Arabel	Neron
Larisa	Trefor
Emmey	Patric
Almeria	Marten
Vitia	Donn
Lola	Phillipp
Nessy	Salvador
Aimil	Claudell
Glyn	Cary
Gretna	Sherm
Rochella	Reginauld
Leanor	Hayward
Bunny	Bartel
Auguste	Garik
Renee	Nester
Athena	Bren
Elle	Augusto
Stoddard	Andrus
Pat	Ignatius
Wilone	Svend
Lorrie	Abe
Roshelle	Dilly
Elenore	Earl
Adda	Leeland
Talia	Morton
Genevieve	Thaddeus
Cindy	Raddie
Lauryn	Desmond
Ethelin	Rolland
Arluene	Yulma
Hilde	Jasper
Elga	Lin
Lari	Malchy
Lanette	Yank
Oralee	Poul
Caron	Hilarius
Loutitia	Alwin
Raquel	Noby
Ingunna	Fields
Margot	Wyatt
Anthea	Gus
Chickie	Alvan
Deni	Jake
Lenore	Durand
Phyllida	Lyon
Honoria	Hamel
Aubrey	Gherardo
Tamarah	Raynard
Afton	Hurleigh
Claire	Ronny
Lanae	Pete
Rana	Vincenty
Hildegarde	Salem
Francoise	Gaylor
Phaidra	Foss
Nedda	Wolf
Doralia	Kippy
Octavia	Casper
Alyce	Tan
Faustine	Zak
Valerye	Malchy
Traci	Garrard
Joli	Yancey
Farrand	Bert
Liane	Farlee
Amalee	Clyve
Evangelina	Lynn
Norry	Nealon
Dorita	Flint
Marlena	Oswell
Jolene	Steward
Ulrika	Carrol
Daisey	Hendrik
Lanita	Mayer
Blanch	Obie
Storm	Culver
Zia	Rockie
Tatiania	Diarmid
Laurianne	Job
Isadora	Hamlin
Susy	Boote
Ivy	Alaster
Arabel	Ogdan
Alyce	Davidson
Annora	Nevile
Sophie	Taylor
Blisse	Hobie
Carolyne	Hewett
Janet	Josias
Ardelis	Ambrosius
Inessa	Hort
Nicole	Rogers
Addy	Phillipe
Sheelagh	Ulysses
Elyse	Gerardo
Drucie	Thorndike
Lexie	Finley
Bernelle	Derry
Loretta	Zach
Nicoline	Gian
Shirlee	Obidiah
Jaquelin	Rufe
Blanche	Free
Brandi	Reagen
Leticia	Rickie
Madelena	Sawyer
Carroll	Horatio
Nadya	Roi
Alameda	Park
Ammamaria	Brook
Enrika	Isaak
Gusti	Tiebout
Marina	Dilly
Cecilla	Mark
Essy	Everard
Lindsay	Bartie
Vevay	Piotr
Angelina	Freemon
Lulu	Amos
Bryna	Benedikt
Cicely	Abbey
Doloritas	Kurtis
Valenka	Jasun
Farand	Griffie
Libbie	Eugenius
Georgina	Jervis
Regine	Gerrard
Megan	Tally
Norean	Sutton
Devina	Damien
Averyl	Ferrell
Mignonne	Saundra
Modestine	Ario
Sibbie	Towny
Rose	Jimmy
Roana	Pieter
Esmaria	Udale
Tamar	Jule
Leann	Gill
Vinni	Loren
Lolita	Chip
Devonne	Addison
Cory	Stern
Trescha	Gifford
Deidre	Gannie
Charlotte	Dillie
Codi	Anatol
Dione	Hillie
Eveline	Thebault
Letta	Mac
Suzann	Prentiss
Sophey	Archibald
Lia	Roderic
Meta	Ivor
Beitris	Dale
Shanon	Clemmie
Kristel	Waverley
Sheilah	Tristan
Arden	Salvatore
Belicia	Hasheem
Ira	Hobie
Taffy	Linus
Lavena	Pattie
Erna	Edsel
Neile	Merry
Nora	Christoffer
Monah	Lucas
Jania	Vinny
Abigale	Nappie
Tiphanie	Gabriele
Katya	Tremayne
Babbie	Stavros
Angelia	Kimble
Elka	Quincy
Fayina	Adrian
Constancia	Ossie
Pearl	Willis
Prisca	Skylar
Lil	Claiborn
Hetty	Neill
Nicki	Early
Tiphani	Marc
Allsun	Anders
Harriett	Nikita
Orsola	Tudor
Aubree	Lem
Betta	Hyatt
Lydia	Errick
Alene	Gaspard
Lane	Oswald
Christian	Tymothy
Arlette	Yorgos
Giovanna	Denney
Jeane	Adolpho
Marina	Ethelred
Augustine	Dar
Grissel	Creigh
Danette	Jamesy
Retha	Tull
Alexina	Rolf
Felicdad	Colin
Deeann	Obie
Maris	Hamid
Fanchette	Haydon
Caressa	Duky
Jenni	Coop
Veronique	Gene
Dori	Tris
Simonette	Garrett
Margit	Valentino
Kelila	Cristiano
Paola	Clementius
Harmonie	Estevan
Miriam	Huntington
Aviva	Evin
Estrella	Keene
Kylen	Morty
Karrah	Parry
Enrichetta	Lodovico
Aurel	Anatole
Brooke	Romain
Malinde	Simmonds
Eileen	Hadrian
Marcile	Konstantin
Sissie	Levey
Leontine	Oliviero
Kira	Augustine
Aridatha	Theo
Catina	Alano
Janeva	Shepperd
Nonah	Israel
Zahara	Sanson
Sileas	Bailie
Josephine	Ogdan
Dynah	Harv
Ronica	Gregorio
Marianna	Rogers
Frederica	Timotheus
Karie	Ewell
Laurena	Jodi
Elene	Hilliard
Hester	Ruddy
Henka	Nev
Caitlin	Lucius
Wilma	Patric
Nyssa	Malcolm
Celesta	Petey
Ann	Hube
Jacklin	Cyrill
Nissie	Tore
Dominica	Prentiss
Melina	Iosep
Noelle	Smith
Ronica	Dorian
Corry	Sylas
Esta	Gonzales
Sherie	Garek
Lotti	Quintin
Reba	Sergei
Ethel	Rollo
Ardenia	Hewie
Julia	Alvis
Crissie	Mallory
Arda	Nealy
Elyssa	Wadsworth
Celeste	Baird
Nertie	Sergent
Alejandra	Lisle
Janice	Marcelo
Eunice	Jehu
Adaline	Reynold
Leyla	Lay
Matelda	Fair
Domeniga	Nevin
Jonell	Yancy
Esmaria	Yulma
Diane-Marie	Hobey
Mariele	Blair
Mead	Giorgi
Zorah	Natal
Fanny	Bing
Riva	Bruno
Natassia	Donaugh
Florinda	Michail
Lilian	Craggy
Rycca	Fields
Mersey	Arie
Kate	Maurice
Kettie	Perren
Philis	Virgil
Marcille	Demetrius
Brigida	Padriac
Eleanora	Ritchie
Gretchen	Lucias
Kelcie	Vaughn
Genny	Emlen
Kimmy	Foss
Fallon	Tuck
Concettina	Richard
Addy	Howard
Leonora	Erick
Ora	Yance
Inga	Thurston
Cristine	Hammad
Julee	Harrison
Faydra	Kirk
Juliann	Baily
Davita	Bale
Terra	Taber
Melisandra	Wyndham
Rozele	Haven
Fidela	Curt
Kath	Boote
Kylynn	Erie
Fayette	Jaime
Tabby	Grantham
Dorthy	Binky
Isabel	Edmon
Manda	Gunter
Jorry	Robin
Felicity	Haywood
Shirlee	Aldon
Lucy	Montgomery
Sybila	Matthus
Lula	Mayor
Laurella	Jarred
Blaire	Pernell
Niki	Ermanno
Nana	Pennie
Pam	Cecilio
Carry	Bary
Elyse	Lonny
Trenna	Chancey
Kai	Fabian
Rhiamon	Toddie
Genia	Hoyt
Klarika	Balduin
Isidora	Cecil
Livia	Joe
Melinda	Roth
Lory	Rudiger
Dominga	Huberto
Vannie	Massimo
Annabelle	Billy
Harley	Ewart
Cori	Sonnie
Janel	Elnar
Celle	Alexandros
Nolana	Randolf
Melamie	Enos
Magdalene	Yulma
Ericka	Augie
Loleta	Carce
Juliet	Hurley
Neile	Tiebold
George	Tedmund
Kit	Daven
Cora	William
Nessa	Granny
Sisile	Urbano
Kalinda	Rufe
Horatia	Finlay
Corina	Jarrad
Sandra	Perice
Oneida	Martino
Bambie	Jodi
Marris	Niel
Veradis	Christoph
Angelle	Bobby
Amandy	Pincus
Gina	Alyosha
Nyssa	Phillipe
Rochella	Siffre
Joleen	Tam
Dyanne	Olenolin
Stephie	Lesley
Renae	Noak
Marley	Radcliffe
Eddy	Sheridan
Regan	Jeremie
Lanae	Virgil
Madelyn	Romain
Chrysler	Padraic
Allianora	Law
Shara	Fabiano
Janetta	Mordecai
Rici	De Witt
Rubie	Aldo
Merrily	Andrey
Shina	Virgilio
Agathe	Tiebout
Jacquetta	Rodrick
Neile	Sky
Mildrid	Zared
Rasia	Leonardo
Manya	Avigdor
Peta	Godfrey
Lin	Regen
Dominga	Stephan
Jodee	Ellery
Brandise	Michal
Alissa	Melvin
Petunia	Germain
Ernestine	Lyman
Karie	Bill
Billy	Tallie
Etti	Burk
Lucine	Darrin
Deena	Luigi
Katuscha	Gawen
Yolanda	Sonny
Celeste	Jerrie
Guglielma	Aubert
Aubree	Mill
Aggi	Finley
Gabriell	Donalt
Cami	Basile
Ines	Thurston
Brande	Win
Catharina	Claire
Margery	Baxter
Robina	Kit
Venita	Morlee
Elaine	Denver
Malory	Corbet
Charmain	Ransom
Dena	Elvyn
Thia	Reece
Mora	Kellby
Barb	Nevins
Celestyna	Wash
Bernita	Theodor
Ilsa	Stearne
Kari	Fair
Miguelita	Georas
Olwen	Oby
Mari	Hastings
Abigale	Tabby
Roseline	Adan
Hendrika	Ripley
Joannes	Mordecai
Clovis	Edlin
Erica	Orion
Annadiane	Wynn
Flossy	Stavro
Harley	Shea
Sioux	Anson
Elysia	Yehudi
Amye	Zacharie
Alie	Ralf
Eileen	Olly
Josephine	Kennett
Berti	Alonso
Retha	Phil
Betty	Cosimo
Guendolen	Cam
Olva	Jerrie
Susanna	Shawn
Caitlin	Greg
Atalanta	Doug
Mira	Filberte
Barby	Arin
Jasmine	Boigie
Ailee	Sanderson
Arline	Hamilton
Ardyce	Spencer
Marin	Yorke
Ashien	Coleman
Elora	Rob
Camile	Willdon
Brynna	Adair
Roseline	Emerson
Ileana	Elijah
Allx	Aldo
Gretta	Jule
Nessie	Nahum
Patience	Johnathon
Ulla	Rad
Mandy	Con
Brandy	Reade
Ana	Travus
Maurene	Mikey
Emilie	Ray
Abra	Yvor
Demetris	Chan
Alicia	Bastian
Torrie	Oran
Adi	Sigismund
Ronnica	Shurwood
Adeline	El
Lesli	Darrin
Cassondra	Hammad
Waly	Torey
Gianina	Demetri
Mickie	Antony
Katherina	Chase
Ansley	Thibaut
Liva	Obediah
Peg	Sven
Ingaborg	Douglass
Lind	Neil
Suzi	Thaine
Jeni	Ambrosio
Carri	Benedick
Merle	Seward
Mandie	Cyrill
Chelsea	Isidoro
Carolan	Cull
Shay	Oren
Aeriell	Cosmo
Maren	Olav
Mathilda	Gallagher
Rene	Georgy
Lora	Levy
Minnaminnie	Jan
Agathe	Carson
Simonette	Rip
Ealasaid	Maynord
Aggie	Briggs
Cybil	Andrey
Timothea	Konrad
Celinda	Lin
Devondra	Wyn
Layla	Alexis
Elnore	Brand
Laurianne	Silvano
Rachel	Justen
Gwenette	Broderic
Myrta	Kendricks
Minette	Sumner
Brook	Kennie
Evangeline	Bruis
Cathee	Tyson
Lila	Melvyn
Lexi	Nikolaos
Anet	Brandy
Timothea	Neale
Fedora	Valentijn
Dina	Kleon
Jacinta	Andrej
Rahal	Shay
Prudy	Bartolomeo
Henka	Tarrance
Ruperta	Thorndike
Melonie	Jarad
Gertrud	Torrey
Jsandye	Durante
Jemmie	Algernon
Ginnie	Brendan
Dredi	Rickie
Moyna	Mohandis
Jillane	Taddeusz
Christiana	Quentin
Roseanne	Scottie
Martha	Dino
Alverta	Stanislaw
Eolande	Inglebert
Melisent	Cornell
Caren	Raymund
Carlin	York
Merna	Reider
Dara	Courtnay
Jacquelynn	Ibrahim
Theda	Giusto
Kathleen	Paulo
Saloma	Hewitt
Nickie	Ermanno
Morena	Roderick
Ophelia	Manuel
Hyacinth	Paxon
Rori	Ransom
Nike	Ewart
Ellene	Enos
Idalia	Burnard
Regine	Birch
Meridel	Conrado
Florry	Dunc
Martelle	Trumann
Carroll	Alf
Shelli	Kenn
Daloris	Huntington
Teddi	Markus
Laurel	Emanuele
Merilee	Burr
Alexa	Gorden
Gerladina	Nikki
Cele	Hewett
Jerrilyn	Chico
Gleda	Freedman
Chandra	Fidel
Nerissa	Langsdon
Anni	Hunt
Orsola	Wood
Faustine	Alasteir
Goldia	Thatcher
Matelda	Ase
Farrah	Gino
Roxi	Marijn
Tani	Markus
Sunny	Steven
Bambi	Marijn
Anni	Errol
Donna	Brantley
Tony	Saunder
Odella	Dmitri
Emalee	Sully
Loretta	Thadeus
Catharina	Paddy
Anastasie	John
Nollie	Boot
Isabel	Parnell
Kora	Adrian
Brandice	Patric
Kerrill	Tome
Eartha	Deane
Dulce	Buddie
Linnie	Ahmad
Ursulina	Schuyler
Elissa	Bay
Oralia	Kalil
Gayleen	Brockie
Cherise	Clemmy
Christean	Alano
Emily	Delainey
Milicent	Cecilio
Leontyne	Grange
Fannie	Wye
Enrika	Wade
Laureen	Emanuele
Jacynth	Percy
Inessa	Major
Lotte	Avram
Pansy	Giselbert
Kelila	Natal
Linnet	Leland
Tallou	Herman
Celina	Beauregard
Lorianna	Aluino
Gwenny	Frasco
Tyne	Erl
Eolande	Nicol
Ettie	Maurits
Olympie	Ruby
Valentine	Rikki
Clio	Schuyler
Dorelle	Gonzales
Dennie	Cece
Elene	Torrin
Dorena	Hube
Madelyn	Mano
Adey	Hurley
Gretal	Marchall
Lissie	Frasquito
Vilma	Lance
Gratiana	Hakim
Adelice	Chicky
Yalonda	Leonard
Gabriell	Ingelbert
Heda	Farlee
Caro	Quent
Clemmie	Herc
Candide	August
Maurizia	Nye
Belita	Brice
Othelia	Giffard
Constance	Benoit
Rosa	Demott
Jori	Milton
Odella	Stacy
Chere	Merv
Kelci	Jack
Aleta	Joachim
Dolley	Howie
Winnie	Constantine
Dorene	Phillipe
Shir	Toddie
Merrill	Freedman
Sioux	Nye
Meggi	Daven
Samantha	Kingsley
Lois	Gaylord
Eadie	Karlens
Simona	Keary
Vitoria	Beau
Billy	Jerri
Amberly	Nahum
Elana	Raimund
Yelena	Iorgo
Leigh	Iorgo
Claudetta	Warner
Brandice	Chucho
Alana	Baxter
Damara	Sid
Lesya	Christie
Jana	Vite
Guenna	Demetris
Gretal	Willi
Malinde	Witty
Sibbie	Alric
Carlye	Jaimie
Eddie	Quintus
Jeniece	Duffy
Shaylynn	Niki
Nady	Brendin
Benedetta	Giles
Norah	Adler
Mignonne	Demetri
Felecia	Cullen
Gwenore	Martin
Davine	Bernard
Berty	Barclay
Nat	Rodolph
Dorise	Giselbert
Ethelyn	Poul
Arlana	Ferd
Zoe	Rocky
Farica	Carey
Ania	Sebastien
Harriot	Vanya
Brigitta	Ximenez
Nora	Ugo
Gerda	Aube
Francene	Norman
Tammy	Ulysses
Carilyn	Grove
Quintina	Gavin
Krissy	Mendie
Morissa	Kaine
Elke	Timmy
Isis	Rory
Teddie	Osbert
Nina	Erny
Susanetta	Augustus
Annalee	Timotheus
Dianemarie	Sampson
Shalne	Hammad
Hedvig	Ximenes
Brenna	Nealy
Bunnie	Shamus
Elita	Welbie
Kelsey	Mendy
Abra	Leonerd
Mora	Weber
Orelle	Gibbie
Blondy	Neal
Clovis	Chan
Bev	Wyatan
Reina	Mose
Merrile	Norrie
Brenn	Ethelred
Gael	Darrick
Cecilia	Glenn
Shelba	Kayne
Masha	Jose
Janie	Abramo
Marleen	Ronnie
Lindy	Kasper
Mureil	Inger
Amabel	Bailie
Wendy	Gardner
Janette	Granthem
Maire	Way
Lissy	Patric
Rasla	Phil
Clo	Antonin
Cherilyn	Isidro
Tildy	El
Alfi	Cchaddie
Rahal	Bastian
Tammara	Francisco
Winonah	Robinson
Livvyy	Des
Gisella	Geordie
Tootsie	Langston
Aaren	Reinhold
Noelle	Alessandro
Vivyanne	Trace
Mei	Harlen
Shirleen	Aristotle
Naomi	Arv
Carree	Travus
Sashenka	Gayle
Joelynn	Derek
Silvia	Dexter
Ginelle	Kurtis
Ethel	Gannie
Chrystel	Terrel
Ina	Ches
Nessa	Isidro
Barbey	Nealy
Afton	Doy
Jenilee	Rodger
Camellia	Wilmar
Koressa	Luis
Candie	Hodge
Mabelle	Spike
Koressa	Darwin
Gusella	Robbert
Kellyann	Tomlin
Lucy	Kippar
Kalinda	Norby
Cele	Jamesy
Rhiamon	Joshuah
Jayme	Kalvin
Consuelo	Ellerey
Elna	Gian
Dacie	Dewey
Idalina	Matthias
Hinda	Bordie
Wileen	Theodoric
Cacilia	Christiano
Ursulina	Dunn
Tedda	Etan
Tate	Aymer
Tony	Ole
Modestia	Gavan
Morgana	Garreth
La Verne	Armstrong
Kirsten	Aymer
Cecilia	Woodie
Shelley	Elvin
Tamiko	Arlen
Mufi	Cad
Lila	Kaine
Addy	Pennie
Madelina	Layton
Bertha	Lorens
Randa	Maison
Hayley	Wain
Sissy	Winthrop
Sandra	Chrissie
Kathryne	Bernardo
Vita	Wylie
Alana	Lyman
Corinna	Joshia
Selle	Grove
Malissia	Zackariah
Marianne	Reagan
Cristi	Huberto
Lorine	Any
Nolie	Lin
Delilah	Skelly
Valeria	Derby
Maisey	Gar
Martynne	Clemente
Belinda	Spence
Kelcey	Dwight
Sally	Jackson
Flory	Barrett
Wini	Devlin
Georgeta	Garek
Ceil	Peter
Lotti	Cos
Erda	Erny
Patti	Arie
Daisey	Morley
Kelly	Cullen
Loni	Burgess
Carlina	Buckie
Lilias	Gordie
Marga	Hanson
Lauralee	Micky
Linnie	Augustine
Selma	Alberik
Kaitlynn	Bancroft
Arlina	Nickolai
Daveta	Silvanus
Easter	Raymund
Ellissa	Donnell
Allegra	Samuele
Jilly	Cirilo
Harley	Antonino
Tessa	Marsh
Martha	Edsel
Jewell	Putnem
Myrta	Barnabe
Laurella	Cam
Loralyn	Guilbert
Annabella	Christoffer
Melisande	Tammie
Maureen	Glen
Laurel	Raul
Thomasin	Virgie
Sonya	Cully
Aile	Gunar
Vittoria	Maurie
Lorilyn	Friedrich
Lanette	Gaelan
Bili	Harbert
Ninette	Newton
Bili	Nils
Poppy	Keenan
Belita	Jedd
Jillian	Lorin
Sam	Winthrop
Vi	Ernie
Benetta	Henderson
Danell	Ash
Zorina	Skylar
Aigneis	Yule
Annabal	Leo
Devi	Harvey
Idell	Antonino
Abby	Norton
Guillema	Jeromy
Lorne	Briggs
Katuscha	Asher
Tera	Benyamin
Bee	Tabbie
Karole	Homer
Bell	Anthony
Claudine	Terrill
Emelyne	Graig
Yetta	Newton
Melly	Kev
Merl	Rem
Agneta	Martainn
Carolan	Smitty
Alvira	Ignaz
Emmye	Gawain
Dion	Ray
Joby	Tyrus
Venita	Nat
Tally	Ev
Christiana	Scot
Orelia	Sammy
Jacki	Byrle
Martha	Orson
Zora	Bryanty
Gwyn	Broderic
Deina	Kelvin
April	Emerson
Freda	Freedman
Clari	Hank
Rahal	Chucho
Mareah	Benjy
Martina	Estevan
Zulema	Barn
Francisca	Royal
Modestine	Benjy
Bellanca	Cello
Vania	Dall
Natasha	Yul
Willamina	Noble
Joeann	Hoyt
Maryellen	Gallagher
Tony	Eugenius
Karyn	Dav
Reena	Zack
Bobbee	Salomo
Juanita	Baillie
Calla	Carly
Nedi	Sergeant
Drusy	Keene
Michel	Bordy
Mildrid	Bayard
Loleta	Weston
Nydia	Raddy
Ofella	Martyn
Barb	Lovell
Kaitlyn	Rolph
Tasha	Ronald
Noemi	Humphrey
Olwen	Willi
Di	Vail
Bibbie	Normie
Sari	Burnaby
Nata	Alonso
Sela	Giraud
Dynah	Robby
Grata	Donal
Danit	Sanford
Sheela	Scottie
Jenifer	Julio
Eolande	Wyatt
Peta	Nestor
Clarisse	Forest
Scarlett	Terrance
Fredra	Hobart
Caryn	Kenn
Sileas	Harold
Kimbra	Bartholomew
Eleonora	Pierre
Correy	Jayson
Allx	Derward
Easter	Tamas
Cortney	Zachery
Tiffy	Parker
Edna	Quintus
Jillie	Morley
Daile	Mycah
Jilli	Giselbert
Sophia	Pacorro
Allene	Orion
Pauline	Gris
Kesley	Erskine
Klarrisa	Clayson
Gratiana	Toddie
Felisha	Winn
Veronika	Johann
Dolly	Carlyle
Kala	Mathias
Valenka	Pepillo
Dotti	Franklyn
Lia	Cordell
Paule	Vail
Rasia	Nikolaus
Ailina	Clemmie
Audrie	Chandler
Rosa	Tailor
Tarra	Tabbie
Blanca	Pren
Ardyth	Udell
Ara	Bradney
Flor	Salmon
Mollie	Merwin
Ginelle	Chris
Alis	Hewett
Daile	Johny
Clareta	Biron
Amaleta	Mill
Jaquenette	Fernando
Deanna	Emmery
Bianca	Shane
Teresina	Laurent
Lilia	Reagan
Brooks	Alford
Annabel	Phineas
Bessie	August
Juanita	Gaultiero
Nessy	Abeu
Dorrie	Maurise
Estele	Alanson
Francesca	Alvy
Constancia	Fritz
Sharl	Leo
Raye	Sutherland
Marjy	Alan
Lina	Ali
Roseanna	Sayres
Charyl	Gaylor
Arline	Gordie
Lanette	Dell
Bebe	Gare
Beitris	Cirilo
Dacey	Dylan
Elisha	Aldo
Lorrin	Frasier
Jehanna	Addie
Edythe	Bastian
Darbie	Jeremy
Harmony	Orson
Saraann	Grant
Rhianna	Marvin
Elora	Angel
Fleur	Rolando
Ardene	Berkeley
Liuka	Patrizius
Margie	Dory
Zora	Anatollo
Cthrine	Garwood
Lilas	Gaven
Fernanda	Levi
Rori	Curt
Dale	Fredrick
Twila	Griz
Madelyn	Lovell
Ailee	Job
Dorothea	Tristan
Roseanna	Godfrey
Kirbee	Zachery
Kimberlyn	Kennie
Danni	Bendicty
Frederique	Torrin
Coralie	Yorker
Annaliese	Terencio
Doro	Aldous
Merrielle	Marty
Kaila	Johny
Lorianna	Ollie
Katharyn	Quill
Shell	Demetre
Blakeley	Bret
Camilla	Aldrich
Tera	Tulley
Cyndia	Lazar
Georgeanna	Forester
Kinna	Bret
Adriana	Isaiah
Bell	Vachel
Talya	Em
Marinna	Torrance
Vallie	Mayne
Amelie	Mattias
Ambur	Guglielmo
Ricky	Tabb
Abbe	Trevor
Janela	Rodge
Lind	Obidiah
Cindie	Gerardo
Karalynn	Barclay
Sindee	Abeu
Amandie	Ivor
Chandra	Chariot
Harmonia	Erek
Peg	Ryley
Debra	Llewellyn
Ruthy	Lucian
Alexi	Myron
Devon	Ernestus
Gerty	Nathanial
Darby	Hartley
Callie	Brett
Rey	Lauren
Reta	Smitty
Malorie	Grantham
Jaquith	Jocko
Arielle	Abraham
Perla	Gil
Willette	Ingemar
Marsiella	Isidor
Margarete	Vachel
Abbie	Guilbert
Theodora	Thatcher
Nicolle	Findlay
Sukey	Westbrook
Dacie	Elston
Rebekkah	Tome
Conchita	Iggy
Noelyn	Noll
Rivalee	Alec
Fern	Damien
Nelle	Sylvan
Wenonah	Roy
Janessa	Batholomew
Phebe	Olag
Valida	Egon
Marjory	Sayers
Tansy	Gasparo
Tricia	Zachariah
Twyla	Warren
Gail	Budd
Natalee	Cordell
Barbra	Gerrie
Marcy	Grange
Saba	Hugues
Celine	Gregorius
Sher	Myer
Ronnica	Lowell
Timmi	Prince
Rahel	Cyrus
Marji	Eduardo
Fedora	Herc
Lilli	Court
Kimmy	Marve
Teri	Traver
Nelli	Adolphe
Dawn	Saxe
Roobbie	Marv
Andreana	Milton
Donelle	Sibyl
Benni	Rodolph
Robena	Gerek
Maureene	Scarface
Leia	Laurence
Wilona	Alano
Josepha	Madison
Dasi	Clayson
Gwenora	Miller
Chastity	Farrel
Winonah	Desmund
Ula	Etan
Zonda	Bern
Luce	Haven
Tami	Turner
Idette	Kincaid
Janetta	Cullen
Enrika	Barbabas
Aubine	Goddart
Imogene	Lewie
Minette	Walther
Karie	Smith
Connie	Pauly
Berri	Forbes
Krystalle	Matthiew
Quentin	Clemmie
Aurlie	Lucias
Marielle	Ermin
Laurena	Egan
Chris	Nicky
Chelsie	Deane
Anica	Menard
Noelle	Nicholas
Zita	Shell
Candi	Lowe
Cherey	Obidiah
Yolanda	Krisha
Amy	Dermot
Fiorenze	Faulkner
Kiley	Gerry
Albina	Harwell
Gaby	Finley
Datha	Basilio
Zilvia	Jeremie
Inge	Mozes
Loise	Law
Darsey	Howie
Kelley	Cory
Clarita	Brody
Melisse	Humberto
Christa	Syd
Cassey	Prent
Konstanze	Christoper
Zsazsa	Keith
Riki	Towny
Sharai	Gino
Donella	Julio
Bernetta	Jamal
Enid	Van
Riki	Hamil
Nelly	Gale
Dorolice	Gardie
Yoko	Mort
Tricia	Gustavo
Debbi	Kane
Papagena	Pepe
Selestina	Desmond
Brenn	Maynard
Katuscha	Pace
Sabra	Algernon
Zitella	Krispin
Yolanda	Chan
Andriette	Ikey
Peg	Lauritz
Colette	Chet
Jeanelle	Scot
Hedwiga	Kippy
Catie	Arty
Thelma	Matthieu
Nellie	Seamus
Chrysa	Dwain
Shauna	Wat
Nat	Brendin
Dela	Claiborne
Robina	Kristopher
Tyne	Itch
Esmaria	Manolo
Lonnie	Kippar
Odette	Mozes
Danyette	Em
Helge	Mel
Maureene	Ernst
May	Rolando
Morgan	Burt
Berte	Jerri
Genny	Rogers
Tonye	Ara
Moria	Randell
Sonni	Fonsie
Natassia	Griffith
Griselda	Hale
Cordie	Ned
Modesta	Sollie
Sheryl	Launce
Cornelle	Gabie
Phoebe	Wit
Tandi	Rriocard
Tilly	Grace
Evangelin	Garrard
Danila	Ahmed
Eleanore	Ozzy
Alica	Martino
Jerrine	Sheffy
Monika	Nealy
Cornela	Gordy
Gerri	Sherwood
Shay	Willdon
Melonie	Lindon
Rosalind	Wilek
Devi	Orland
Darryl	Leonhard
Dorrie	Lalo
Conchita	Mohandis
Selia	Dud
Datha	Boigie
Amelina	Granthem
Irena	Trace
Helaina	Meyer
Amelina	Vladimir
Leticia	Yance
Larisa	Jefferson
Natalee	Durant
Minny	Base
Trixi	Keary
Starlene	Rudie
Winnifred	Kim
Betta	Dew
Kai	Delmor
Catie	Ario
Corine	Joshuah
Audie	Hewett
Marijo	Pail
Ruthe	Scot
Ibby	Meir
Hester	Bucky
Verina	Patrizius
Kimberli	Abey
Bobette	Blake
Giorgia	Archibaldo
Rita	Murvyn
Ashlie	Smitty
Reeva	Dore
Xylia	Randolph
Judith	Vincent
Jojo	Phillip
Sibby	Sammy
Cam	Corbie
Nicole	Noak
Yasmin	Dorie
Catharina	Mylo
Reeva	Korey
Bunni	Rinaldo
Daniella	Mathias
Calypso	Dannie
Olva	Thorpe
Dorree	Jeffie
Vere	Oren
Tiffani	Cullie
Anjela	Jarrid
Linnea	Ulrick
Sharyl	Deane
Vanni	Elmer
Cam	Sancho
Austin	Vanya
Collie	Cello
Novelia	Axe
Tawsha	Sebastiano
Bernadina	Frederich
Josselyn	Randolph
Kip	Garrick
Lynne	Luigi
Molli	Lem
Velma	Delmar
Gaylene	Brigg
Ashlen	Dario
Maggee	Isak
Ivie	Filbert
Caroline	Callean
Eleonora	Benedick
Josefina	Simon
Dulce	Hobard
Alyda	Thaddeus
Ammamaria	Chucho
Franciska	Aron
Dulci	Dael
Francine	Innis
Julia	Darn
Daffie	Barny
Essy	Weidar
Gerti	Eddy
Paloma	Ingemar
Ursala	Maxwell
Genni	John
Othilia	Dugald
Luisa	Norton
Audrey	Dannel
Hollie	Matias
Beverley	Kayne
Blair	Farlay
Stevena	Skelly
Jessamyn	Spike
Roselin	Godard
Binnie	Dennison
Chandal	James
Sidonia	Levi
Stefanie	Ade
Tami	Scott
Samantha	Kurt
Starlin	Orazio
Ileane	Aloin
Guendolen	Kit
Siouxie	Dallon
Angelika	Zachariah
Valery	Stavros
Honoria	Dane
Appolonia	Orbadiah
Constantia	Barret
Maggi	Reagan
Darsey	Martin
Jo	Victor
Dodi	Walt
Loree	Neddie
Bunnie	Conant
Kora	Marmaduke
Melisande	Emmett
Sasha	Shaine
Dionis	Padraig
Crin	Adler
Alfy	Alan
Ruthann	Othello
Deena	Sayers
Ariana	Currey
Joly	Peter
Koralle	Xavier
Bird	Christos
Daisie	Feodor
Kirbie	Fonz
Yoshiko	Garner
Shelli	Heinrick
Florrie	Edward
Katusha	Gaven
Josefina	Mart
Wynn	Mike
Sibilla	Elbert
Lydia	Heywood
Marlee	Artemis
Livvy	Stearn
Priscella	Panchito
Maribel	Tomkin
Brina	Edik
Philis	Jonathan
Charla	Jo
Cindy	Elliott
Ermengarde	Urbano
Tonya	Aldin
Valene	Matthiew
Dennie	Evan
Dixie	Derby
Katleen	Ned
Thomasine	Emory
Annalise	Haze
Roseline	Garrard
Norry	Shaughn
Adena	Jesus
Kelcey	Anders
Krystal	Nathanael
Lurette	Quent
Wallis	Zak
Hedvig	Balduin
Dorian	Florian
Peria	Jody
Eddy	Hermie
Michaeline	Hanson
Gwyneth	Michele
Wandie	Axe
Aleta	Ignacio
Hollie	Casper
Maria	Petey
Aloise	Boycie
Doris	Windham
Lucina	Alexandros
Jeane	Cheston
Reena	Nels
Dore	Johann
Cecile	Towney
Garnet	Ganny
Alexine	Ulberto
Deloris	Stern
Salli	Markus
Nanete	Tabor
Tammie	Pierce
Pegeen	Ethan
Crystal	Garv
Ardine	Clayborne
Stace	Ellwood
Magdalena	Isidoro
Olwen	Mikey
Helen	Freeland
Roxanna	Kele
Katey	Sloane
Ashla	Cooper
Elbertine	Kent
Ellynn	Foss
Yvette	Ethelbert
Hildy	Cornelius
Caryn	Pepito
Bettina	Lemmie
Blinnie	Sunny
Marylou	Hayward
Robinett	Adriano
Charisse	Saunder
Merlina	Chaddy
Vernice	Brade
Debor	Dennet
Elita	Graig
Eleanore	Silvan
Marlo	Garrek
Scarlet	Lothario
Gigi	Alexandr
Trudi	Zeb
Ivy	Jaymie
Deonne	Job
Niki	Fonz
Ramona	Alard
Florette	Sheridan
Flory	Chucho
Lenore	Tabby
Marisa	Leonerd
Jacquie	Magnum
Leonore	Upton
Cissy	Hamil
Binni	Aldous
Johna	Rudd
Ida	Egbert
Phyllis	Rancell
Cori	Zelig
Roberta	Frants
Jamima	Bartram
Shantee	Ethan
Kellen	Ingamar
Zoe	Kearney
Lynnet	Booth
Venus	Crichton
Carlin	Reider
Sallyanne	Zeb
Helen-Elizabeth	Worden
Breena	Yale
Adria	Aleksandr
Lorianne	Mack
Lauraine	Wilmar
Tobye	Romeo
Leslie	Herman
Almire	Sibyl
Karin	Roi
Valentina	Antonin
Zarah	Alick
Julietta	Raynor
Adrianne	Neron
Ariela	Templeton
Salomi	Gaile
Davita	Stern
Pearline	Shermy
Kelcy	Ware
Elene	Kristos
Maisey	Ingelbert
Patrizia	Worthy
Garnet	Trenton
Darcy	Heath
Benoite	Ethelred
Fanya	Garvy
Corrina	Jeffrey
Debera	Worthington
Raynell	Rafaellle
Cyndy	Ryon
Linnea	Neils
Maurita	Sanson
Fiona	Zachariah
Charmain	Abel
Becki	Hewie
Daryn	Wake
Ericka	Orin
Venus	Dario
Gretchen	Artemas
Clarette	Cy
Stacia	Rudyard
Mildred	Addy
Debbi	Sanford
Aindrea	Aksel
Lura	Holt
Lise	Pearce
Josefina	Jarvis
Kai	Yuri
Addia	Adrien
Britney	Kipp
Dulcinea	Tynan
Roseann	Karl
Melodie	Patric
Ronna	Saul
Belita	Yance
Cherrita	Joshia
Edythe	Ari
Denny	Stan
Golda	Virge
Fernanda	Bartholomeus
Tammy	Pincus
Ansley	Emery
Germana	Urbanus
Andreana	Alva
Mommy	Frankie
Alikee	Berti
Babara	Man
Wendeline	Benjamin
Florida	Wylie
Noreen	Vail
Henrieta	Jefferey
Adey	Worthington
Myriam	Sutherland
Kristin	Rabi
Janella	Dudley
Ellen	Quint
De	Dicky
Tina	Ebeneser
Astra	Simeon
Dianemarie	Mickie
Winny	Halsey
Christa	Kit
Berry	Pierce
Jo-Anne	Douglas
Anselma	Leighton
Libby	Levey
Pepita	Darrick
Tresa	Adamo
Starlin	Roscoe
Chlo	Ashbey
Denyse	Roarke
Feliza	Torrey
Natassia	Saunders
Rennie	Batholomew
Devi	Claiborn
Dyann	Dwayne
Sianna	Miner
Nadya	Obidiah
Viviene	Oswell
Joye	Brigg
Mellie	Binky
Blondell	Tymon
Gretel	Kelbee
Tera	Artair
Alissa	Marcellus
Carree	Herculie
Georgeanna	Garvey
Karol	Clyve
Cele	Hilliard
Janith	Rowney
Audry	Shaine
Bertine	Gradey
Bertie	Allie
Emera	Malvin
Simone	Teador
Kiri	Franchot
Elayne	Roland
Clementina	Reade
Rorie	Colman
Joelly	Manuel
Sally	Tod
Gerrilee	Payton
Nedda	Sergent
Perri	Elwin
Jannel	Leupold
Kim	Hamel
Jaime	Rufe
Jorey	Nikki
Teriann	Gaby
June	Peyter
Rubi	Kerr
Eirena	Forbes
Toby	Dillie
Leora	Bevin
Phaidra	Chickie
Timothea	Bartholomew
Meredith	Con
Darryl	Hodge
Latia	Lek
Goldi	Sayres
Joey	Neils
Margi	Job
Traci	Bogey
Consolata	Glenden
Angelle	Moss
Loni	Benedick
Genni	Tades
Delphine	Micah
Charmain	Odo
Delila	Brendis
Yasmin	Corbie
Morganica	Lydon
Dorris	Temp
Estele	Jeremie
Leland	Marcelo
Malva	Ly
Doralynn	Angelico
Cassandry	Lorant
Tedra	Artemas
Valry	El
Nadean	Ber
Jobyna	Aland
Ealasaid	Rory
Belicia	Mace
Danice	Alberik
Celine	Bertrando
Flory	Erhart
Roseann	Locke
Elset	Devlen
Ulrika	Kaine
Quintina	Bartlet
Mignonne	Gavin
Louisette	Oran
Myrtie	Winny
Maribeth	Ernesto
Eda	Aguste
Jillayne	Wernher
Melicent	Lucien
Ursa	Uri
Cherice	Valdemar
Cammy	Bryon
Floris	Luciano
Janna	Phillipe
Penni	Aymer
Maryl	Tracie
Reeta	Rafe
Jeana	Abbie
Sada	Ozzie
Tommi	Wye
Kellia	Noland
Kitty	Gregor
Hesther	Uriah
Sophia	Milton
Minnie	Oren
Colline	Salomon
Dosi	Creigh
Gustie	Angeli
Faythe	Adan
Aleda	Stanley
Prissie	Oliviero
Anabel	Red
Jade	Guthrie
Ashley	Kele
Honey	Georgi
Elianore	Craig
Cathrine	Cory
Mariellen	Rriocard
Kirstyn	Mayne
Katharyn	Joseito
Francine	Devland
Ellissa	Maxy
Junette	Malvin
Maribelle	Avrom
Euphemia	Kalle
Kelsy	Luce
Nan	Beniamino
Lisabeth	Julius
Dareen	Jodie
Jackquelin	Ethan
Alvera	Herculie
Inga	Trueman
Maitilde	Christos
Brandea	Gabie
Debbie	Berny
Loria	Alfons
Opalina	Meryl
Carmelina	Humbert
Sharyl	Borden
Reba	Skippie
Sally	Chip
Carlie	Bernardo
Evey	Fabio
Kattie	Tanner
Nora	Yvon
Dalila	Jeffry
Kyle	Stu
Fawn	Brnaby
Melina	Conney
Fifine	Bevan
Stormy	Palmer
Dory	Fonzie
Agretha	Mikey
Karyn	Chico
Betta	Hugues
Mariele	Chad
Margalit	Piotr
Nonah	Osbert
Orsa	Dieter
Avie	Isaiah
Emmi	Cully
Marley	Gonzalo
Cariotta	Leigh
Steffie	Diego
Celene	Waiter
Bobbie	Levin
Ferdinanda	Barnett
Korrie	Dex
Nikkie	Franklyn
Bren	Lothaire
Ginny	Forrest
Dania	Hagan
Nikaniki	Porty
Randie	Nico
Conni	Roman
Gwenore	Dallon
Timi	Gerald
Bert	Amory
Dorthy	Quincy
Aimil	Temple
Mallorie	Wilfrid
Kori	Alair
Shayne	Rutger
Kathi	Jase
Franni	Rochester
Hatty	Penrod
Scarlet	Tomkin
Kathie	Yorgo
Rosemary	Efren
Edwina	Hadrian
Lacy	John
Melanie	Jaime
Perry	Brigham
La Verne	Dionysus
Fanya	Orlan
Glynda	Martyn
Nicky	Rawley
Emalia	Gar
Bobby	Boonie
Casandra	Talbot
Sharlene	Clint
Nicole	Romeo
Gena	Frans
Waneta	Vladamir
Addy	Erasmus
Fionnula	Edik
Bethany	Nicol
Bertha	Cale
Timi	Jecho
Cindy	Gregory
Barbee	Cleve
Bab	Andreas
Goldy	Guthrey
Jillene	Kimble
Minta	Hilario
Alyssa	Thatcher
Esmeralda	Robin
Sophi	Abey
Tabbitha	Derrek
Franciska	Linc
Amalee	Elroy
Tomasina	Olag
Rhody	Claudianus
Chantalle	Mendel
Malinda	Bengt
Cristie	Beauregard
Mamie	Benedict
Rosetta	Gerrard
Hetti	Miguel
Dena	Shay
Tiphany	Erek
Rosie	Nat
Camellia	Hector
Othella	Seth
Agathe	Aylmer
Rosemonde	Si
Elisa	Creighton
Gladi	Irvine
Kaitlynn	Aland
Maggee	Rex
Marlene	Inger
Beverie	Elwin
Willie	Jessee
Gerty	Dimitry
Marcelline	Gael
Guenevere	Khalil
Bell	Rickie
Celka	Mayer
Francine	Nicky
Marian	Adler
Shandeigh	Benson
Aurilia	Jerry
Reggie	Arri
Sara-Ann	Clarke
Poppy	Munroe
Tildy	Den
Gusty	Royce
Klarrisa	Alix
Kerrill	Corby
Mildred	Sonnie
Jaclin	Rustie
Melly	Jeffrey
Josepha	Gal
Darlleen	Tobe
Cherry	Bourke
Maurizia	Hy
Katy	Laurence
Catina	Sauveur
Violetta	Inger
Binny	Roger
Evaleen	Pennie
Elisabetta	Price
Sher	Pincas
Deeanne	Jesse
Gleda	Orson
Devonne	Bondy
Lorene	Rolando
Milena	Darcy
Andreana	Kayne
Lynsey	Oswell
Berti	Valentijn
Marketa	Lonnard
Emmi	Templeton
Quinta	Toddy
Doralia	Humbert
Joanie	Clarance
Jacquenette	Pattie
Corly	Alonzo
Nedi	Rolfe
Silvie	Temp
Aleta	Gaylor
Adara	Correy
Katherina	Sauveur
Verine	Bendix
Dianne	Andrej
Brinn	Conroy
Vittoria	Farlie
Molly	Arny
Shantee	Wildon
Anastassia	Edgardo
Filide	Dav
Carmita	Ody
Cloe	Bradan
Devon	Hector
Eve	Sloane
Hettie	Dolf
Catriona	Andros
Starlene	Aldwin
Birgit	Don
Alejandra	Geoff
Salome	Jed
Consolata	Vite
Rosemary	Leighton
Arlette	Allyn
Janie	Hobard
Blithe	Rutger
Mildred	Gearalt
Shelia	Tomas
Monika	Lemuel
Rosita	Herbert
Tammie	Rey
Leanora	Chris
Isabel	Brucie
Stesha	Patty
Gilberte	Creighton
Edithe	Gard
Gilligan	Artemus
Arleta	Barnabas
Jerrilee	Brant
Kissee	Rockie
Estell	Colet
Lizette	Jedediah
Fleur	Ellerey
Barby	Mano
Charmain	Giffer
Sofie	Parker
Drucie	Halsey
Timmie	Brocky
Matti	Chalmers
Cordy	Garrett
Carrie	Ron
Jeanette	Lovell
Robbi	Raimondo
Ciel	Clerc
Nixie	Nicolis
Merrie	Adrian
Marcela	Fergus
Grazia	Lyn
Lezlie	Desmund
Nerita	Tobiah
Inger	Giustino
Constantine	Johnathan
Anastasie	Decca
Marje	Ethe
Gleda	Butch
Consuela	Nikolaus
Rivy	Marsh
Atlante	Worden
Cindra	Orin
Quintina	Harris
Trix	Galven
Shari	Aland
Ardyth	Mar
Cassey	Sherwin
Kyrstin	Marlow
Glynnis	Ralf
Catrina	Koenraad
Auguste	Raviv
Sarajane	Pall
Jessy	Toiboid
Heddie	Corbet
Terrie	Kenon
Shanon	Drake
Anestassia	Kerk
Guinevere	Olivier
Harriet	Gordy
Ingeberg	Phineas
Lori	Bord
Binny	Wyndham
Laina	Marlow
Letty	Krispin
Lesley	Derron
Starlin	Corby
Trudey	Diarmid
Tiffie	Adolpho
Gertie	Alva
Philly	Randolph
Bathsheba	Boyce
Sadye	Zane
Karena	Dave
Analiese	Purcell
Odille	Simmonds
Bobina	Gaultiero
Margaux	Abie
Nelli	Mattie
Emilie	Giacopo
Gaby	Curtis
Feodora	Salim
Kinna	Norrie
Edithe	Cary
Gunilla	Oswell
Benedetta	Timmie
Noelani	Clerc
Jacquenette	Stern
Pia	Thaddeus
Carol-Jean	Skippie
Sisile	Jodi
Zorina	Davin
Karena	Tobias
Penelopa	Dimitri
Blakeley	Tristam
Gaby	Parry
Jessika	Miltie
Raina	Howie
Karlen	Teador
Jacqui	Adler
Evania	Kaiser
Allegra	Rikki
Marcia	Reginald
Hertha	Rad
Ardys	Harman
Elie	Ivan
Dorotea	Lance
Gerty	Ebeneser
Shirlene	Evin
Marge	Clemente
Krystalle	Saunder
Sande	Ferdinand
Hildagard	Hal
Eula	Justin
Romona	Claiborne
Gwenny	Bartolemo
Adelina	Karim
Ashli	Geoffrey
Federica	Hubey
Nyssa	Kermit
Ailyn	Ozzy
Felisha	Harrison
Martina	Sutherland
Allianora	Kent
Delia	Horton
Rebeca	Hobie
Katherine	Kele
Dyane	Markos
Debi	Erik
Terrie	Mervin
Angelle	Leslie
Johanna	Putnem
Audra	Gerhardt
Henryetta	Drew
Charity	Carolus
Loleta	Wake
Crystal	Yanaton
Keslie	Kelwin
Elna	Neall
Bette	Cornie
Dru	Yorgo
Felecia	Warren
Norry	Bartolemo
Torey	Garwood
Elsbeth	Padget
Francene	Justis
Myrah	Nikolos
Kaitlin	Dalston
Sherill	Timothy
Patrizia	Rudie
Ailene	Guntar
Willy	Dana
Stephannie	Granny
Saree	Rodolfo
Thomasin	Dicky
Cristen	Keary
Adelice	Thorny
Tedi	Damon
Joanne	Wes
Mead	Murray
Maressa	Barn
Trudy	Khalil
Ortensia	Costa
Zilvia	Herman
Evvy	Ev
Krystal	Patrizius
Cody	Davie
Dominique	Cory
Charlotte	Gaspard
Daphna	Chariot
Raynell	Iggie
Rona	Isidor
Madonna	Wynn
Kerri	Grover
Bathsheba	Parker
Theresa	Sigfried
Davita	Franciskus
Marnie	Aristotle
Cassandra	Ric
Moreen	Fonsie
Corrine	Webster
Clementina	Davey
Trenna	Darren
Dina	Yves
Alyda	Wells
Nettle	Rick
Joyann	Lionello
Jenilee	Con
Olivette	Antonin
Rosene	Ogdon
Bernadine	Dewey
Ulrikaumeko	Eal
Sande	Everard
Cyndi	Milo
Emmalee	Cooper
Marni	Casar
Sheelah	Purcell
Dian	Marius
Steffie	Peyton
Philomena	Carny
Ashla	Thornie
Gillian	Magnum
Pepita	Wat
Lenka	Bennie
Marita	Early
Christabella	Byrann
Jacklin	Luke
Alisha	Thorn
Isa	Giorgio
Pennie	Massimiliano
Kary	Tod
Brenna	Joseito
Dena	Abraham
Lara	Rodrique
Randie	Antony
Marquita	Harvey
Rivi	Alvin
Honor	Gottfried
Fern	Gradeigh
Adriaens	Arri
Meridel	Gregoire
Karoly	Vernen
Jyoti	Luciano
Beulah	Cross
Ardine	Willem
Kaja	Kele
Britney	Monroe
Amelita	Demetri
Joice	Tadio
Dorita	Maurie
Devon	Stanislas
Adelina	Yves
Mallory	Clayson
Johna	Carlos
Kamila	Tye
Arabela	Husain
Dulcine	Trevor
Ettie	Saul
Kala	Dare
Nalani	Shelton
Sophey	Giffy
Ezmeralda	Cleve
Alicia	Phillip
Perri	Rudy
Laetitia	Darrick
Eloise	Colan
Doris	Cyrillus
Cornelle	Bogart
Bunni	Ogden
Emelina	Ripley
Liana	Justen
Bellanca	Titus
Clea	Nate
Rania	Uriah
Chelsae	Vincenz
Jessalyn	Hilarius
Hazel	Frasquito
Pat	Ronny
Alina	Chet
Allyce	Antons
Electra	Allin
Lisha	Teddie
Claresta	Gregg
Halli	Page
Barbra	Mitchel
Corrie	Elisha
Sal	Alden
Talia	Xenos
Rachael	Fabio
Geraldine	Melvin
Talyah	Mace
Denys	Zelig
Hilary	Luigi
Kassia	Merv
Anabel	Dmitri
Eula	Townsend
Bellina	Innis
Bernelle	Killy
Alica	Sergei
Sonja	Daren
Dyann	Kale
Dannye	Ernesto
Opalina	Pattie
Joella	Thaddeus
Ollie	Giuseppe
Beverie	Spense
Rozamond	Brant
Kittie	Bronson
Blinnie	Frasier
Alecia	Haroun
Jolynn	Layton
Corabelle	Shaughn
Rosamund	Barnie
Shanna	Moritz
Vinnie	Dillon
Nert	Reuben
Livvy	Brok
Patrizia	Waite
Terza	Steven
Alanna	Ulberto
Chiquita	Neils
Elyse	Bev
Nikaniki	Demetrius
Deina	Kaiser
Merle	Mattheus
Berta	Vick
Ajay	Nap
Janessa	Griffith
Matilde	Justus
Jo Ann	Ruggiero
Fanya	Iorgo
Kalila	Gaultiero
Kinna	Terence
Ann	Horst
Nicolle	Raynor
Stacy	Hurley
Deny	Raddie
Crystie	Silvano
Laure	Andres
Dyane	El
Marti	Cortie
Meade	Garreth
Ilse	Gustavus
Claretta	Cass
Janis	Raffarty
Gabriell	Tan
Ailis	Dilly
Rosalinda	Elihu
Brunhilda	Trever
Yoshiko	Virgil
Gene	Lorin
TEirtza	Kaine
Berna	Felizio
Janine	Kirby
Dominique	Rik
Orelia	Chaddy
Cynthia	Ignazio
Ailsun	Goober
Helge	Peyton
Jilli	Jonathon
Dyann	Abraham
Karlene	Guillaume
Melicent	Rodrigo
Moselle	Heriberto
Wendie	Lazare
Polly	Edgardo
Karine	West
Celia	Amos
Alvera	Emory
Jobyna	Frankie
Tessy	Dominik
Lorilee	Hervey
Dode	Frankie
Drusilla	Doug
Paule	Brice
Elicia	Rolando
Vanni	Allie
Babbie	Tanny
Joellyn	Bordie
Jody	Anselm
Edee	Theodoric
Shandra	Hagen
Caitlin	Giordano
Marylin	David
Gretta	Brannon
Mel	Lindy
Shawna	Alexei
Kaja	Gardiner
Alice	Edd
Sandie	Ancell
Nikoletta	Rogers
Doralin	Raddy
Jillana	Cristian
Sabina	Darill
Pansie	Meredeth
Ulrika	Harvey
Johnette	Malchy
Morgan	Elliott
Brina	Caleb
Ilise	Murvyn
Elvira	Jamil
Terrye	Hirsch
Madeleine	Derwin
Berry	Moises
Leisha	Fowler
Francesca	Randy
Josee	Simon
Anastasia	Salem
Othella	Nils
Jenelle	Rosco
Nessie	Ram
Morgana	Chicky
Gayla	Stewart
Clio	Fran
Laura	Foster
Scarlet	Gibb
Lorita	Rockwell
Ema	Salomone
Ferne	Brodie
Lynnea	Alberik
Angelita	Nathanil
Diannne	Maurie
Rhodia	Ward
Cortney	Leo
Callida	Egor
Deedee	Norbie
Nara	Ado
Germain	Hermy
Nadeen	Frederick
Ruthie	Fields
Carlie	Harry
Sibley	Herbie
Bobine	Tabb
Cyb	Jaimie
Fallon	Rriocard
Antonietta	Paten
Kerrill	Shea
Karie	Sax
Sara	Alvin
Gwenette	Jude
Marita	Itch
Yevette	Layton
Nicki	Gerome
Leda	Lockwood
Noreen	Kermy
Mireille	Edlin
Josie	Derby
Rosemonde	Wolfy
Ursuline	Barth
Dot	Sherwood
Daile	Estevan
Kipp	Morey
Abagail	Mack
Jeanie	Bill
Bambi	Sawyere
Benny	Haroun
Joceline	Alonzo
Darci	Cedric
Tiena	Olvan
Kelsy	Hadleigh
Carolin	Raffaello
Ashly	Towny
Easter	Stillmann
Harmonia	Ellwood
Cilka	Raff
Waneta	Ezechiel
Demeter	Bordie
Cecelia	Angelico
Melli	Gaylor
Abra	Jervis
Kyrstin	Curran
Belle	Wolfy
Crissy	Gus
Vivien	Bronson
Elora	Gavan
Vinita	Alaric
Britni	Kayne
Carlynne	Clive
Denyse	Worthy
Catha	Lazare
Claresta	Pail
Rubina	Merill
Marys	Gardner
Valentine	Monty
Aida	Tymon
Cathrin	Alano
Briny	Pepito
Gilbertina	Kurt
Veronika	Dane
Lura	Michael
Roobbie	Edlin
Honoria	Sloan
Gloria	Frederick
Cissiee	Skipp
Aurora	Jacobo
Donna	Clevey
Allison	Tome
Aileen	Courtnay
Federica	Nels
Orel	Mitchel
Joya	Tymon
Jillene	Renato
Berna	Taite
Lissie	Sherwin
Serena	Perry
Rosemonde	Sutton
Arabelle	Newton
Arabele	Nefen
Angelika	Mickie
Jeana	Sergeant
Jillane	Rutter
Thia	Herve
Noella	Gard
Kirsten	Temple
Dacy	Gabby
Hanny	Vernor
Marena	Tracy
Sela	Ezra
Vally	Herman
Halie	Ev
Shari	Nichols
Ilyssa	Pietro
Roana	Hillie
Jayne	Barth
Sabra	Miles
Corie	Win
Claretta	Cull
Joanie	Corty
Rori	Morly
Penny	Salomone
Roobbie	Elston
Alikee	Merwin
Guillemette	Lewes
Tova	Clyve
Milzie	Shaun
Saidee	Roth
Paule	Justis
Daisi	Daron
Christen	Duky
Faunie	Pennie
Violetta	Vic
Nelli	Parker
Dulcea	Lee
Madelyn	Andrea
Moreen	Urban
Gabbi	Omar
Carena	Donovan
Dehlia	Creight
Cinderella	Millard
Phelia	Harv
Tiphany	Tynan
Julienne	Luciano
Jan	Alain
Nikolia	Paige
Luce	Xever
Amy	Spence
Joan	Merry
Verna	Natty
Daloris	Tab
Adrianne	Virgie
Antonina	Thaddeus
Romonda	Alley
Lelah	Logan
Sharyl	Tabbie
Beverlee	Ichabod
Edi	Jules
Lois	Neale
Shay	Augy
Lanette	Hamil
Doreen	Onfre
Kristien	Yance
Belita	Judas
Lindy	Nikos
Hollie	Chico
Tildie	Barthel
Astra	Ban
Terra	Curtice
Zola	Falito
Klarika	Brody
Deena	Niels
Rubetta	Worden
Estele	Carlo
Toinette	Noah
Yoshi	Woody
Jelene	Raul
Carita	Gayler
Sybille	Moss
Florie	Agustin
Hildegaard	Pepito
Noelle	Guillaume
Kalie	Maximilianus
Kettie	Terrel
Martha	Cletis
Tiffanie	Isaak
Kit	Augustus
Helenka	Domenico
Merlina	Griz
Thomasa	Renaud
Vivyanne	Emlen
Lissa	Pierson
Kiah	Lodovico
Gisele	Immanuel
Luella	Cameron
Shay	Smith
Marleen	Gerhardt
Olva	Joaquin
Sada	Christophe
Mel	Burtie
Jolene	Kerk
Cal	Jeffy
Sibyl	Ewan
Marybeth	Shaughn
Annabel	Gayle
Crystal	Seth
Katerine	Gerhard
Wandis	Dave
Twila	Herculie
Joline	Mason
Larissa	Vlad
Bonnie	Nataniel
Cthrine	Alejoa
Karna	Alberik
Dyann	Brose
Ellen	Hendrik
Addi	Miner
Ruby	Rochester
Renate	Feodor
Lindy	Torrance
Darleen	Henderson
Rita	Onfroi
Roshelle	Vin
Emmalynne	Sollie
Jolynn	Lionello
Annis	Petey
Loleta	Kennan
Andrei	Tamas
Marthena	Brennan
Phyllis	Gradeigh
Amandi	Jude
Ferne	Thurstan
Rozanna	Lombard
Dania	Duane
Pat	Hervey
Shirley	Lazare
Dorotea	Karoly
Edi	Richmound
Roselle	Oswell
Bibi	Colas
Holly	Theodoric
Merilyn	Derrek
Terry	Clemens
Kathy	Meier
Jaclin	Doy
Flossy	Farris
Ronna	Roscoe
Alana	Silvio
Rozalin	Langsdon
Cristine	Wilburt
May	Horst
Selia	Rochester
Brena	Matteo
Geraldine	Jackson
Dorry	Kerk
Giorgia	Ingram
Tasha	Meyer
Ashly	Yorker
Dalila	Hagen
Rafaela	Stanleigh
Remy	Torrey
Hannis	Augusto
Carolee	Gradeigh
Mercie	Frederich
Dorita	Towny
Jackquelin	Trip
Heida	Raimondo
Anjanette	Oberon
Marguerite	Syd
Beatrix	Rafferty
Philippe	Carroll
Robina	Budd
Matelda	Garrek
Heda	Fidelio
Cristen	Quinn
Ede	Correy
Brittani	Stewart
Marthe	Nicolas
Hedvige	Nels
Sela	Rouvin
Sela	Paddie
Adiana	Gibby
Estell	Sigismundo
Augustine	Ned
Christian	Stanford
Pandora	Clayton
Donnamarie	Morgun
Krystalle	Guthrie
Allsun	Arvy
Dela	Patsy
Elsey	Merle
Dorrie	Padraic
Jacinthe	Hastie
Priscilla	Izzy
Bellanca	Gill
Elfreda	Mikkel
Ingaberg	Augustine
Annabel	Val
Sybil	Ernst
Micky	Cyrillus
Sybila	Briano
Lydia	Phillipe
Yolanthe	Barty
Kameko	Nelson
Waneta	Pascale
Berni	Gary
Manon	Vite
Ethyl	Jocko
Ellyn	Griffie
Livvy	Blayne
Candice	Winslow
Jandy	Wallas
Jerrylee	Moritz
Berget	Jeth
Robinetta	Wat
Ceil	Wolfy
Guillema	Tedmund
Fayth	Jereme
Mirna	Roy
Mitzi	Francisco
Wilhelmine	Johannes
Manda	Ignaz
Kalinda	Enoch
Guenna	Robby
Allix	Delmar
Lia	Tarrance
Ardelis	Creigh
Petra	Ingar
Brigitte	Normy
Merilyn	Radcliffe
Gwendolen	Davin
Brandi	Nealon
Nerty	Wallis
Yolanda	Michail
Hannah	Brendin
Sonja	Osbourne
Janessa	Fraser
Ardeen	Tomaso
Aigneis	Nehemiah
Tiphanie	Justus
Shanta	Anton
Melony	Fairfax
Tish	Fidel
Cassy	Wat
Nicholle	Chrotoem
Dee	Gaelan
Sadye	Murry
Lyn	Werner
Chiquia	Neils
Bethanne	Jeff
Roxie	Jasun
Johnna	Eddie
Vivia	Spike
Ivory	Milt
Chery	Pancho
Gray	Lazaro
Ally	Benjie
Marin	Sargent
Tasia	Trent
Gwenneth	Penny
Gunilla	Cullen
Lacee	Rogerio
Gilda	Sully
Dorian	Antony
Shandie	Phineas
Gleda	Kennan
Jeanine	Bron
Lenee	Pierce
Jaclin	Dennis
Adria	Christie
Madelon	Gerick
Cyndie	Kristos
Kinna	Ugo
Hildagard	Westbrooke
Tildy	Alvis
Brandea	Harper
Augusta	Blaine
Delly	Bartel
Eleanore	Garwin
Morna	Pincus
Melli	Guillermo
Janella	Raimund
Zondra	Orson
Eada	Thaine
Silvie	Corrie
Elysee	Bradley
Dorey	Dorey
Mariska	Brice
Margarette	Mic
Kristel	Ulric
Edee	Thibaud
Edwina	Sylvester
Veronike	Hartwell
Alfreda	Quintus
Cherilyn	Myron
Robbi	Georges
Lin	Flinn
Arlette	Darill
Cornelia	Charlton
Fanchon	Hamel
Kore	Umberto
Clarey	Dirk
Patsy	Pierre
Robbi	Sheffy
Konstanze	Rutger
Deirdre	Jethro
Maurizia	Sig
Corene	Boycie
Fionnula	Andrea
Minni	Gustaf
Delila	Tiebout
Emera	Regan
Ralina	Nelson
Wynnie	Fairleigh
Karine	Herold
Amandi	Maison
Domini	Farris
Vicki	Lincoln
Jacqueline	Caldwell
Nady	Lev
Gui	Shay
Roobbie	Warner
Trudey	Pebrook
Maribelle	Cirillo
Pet	Lammond
Nissie	Marcel
Jen	Rufus
Vanny	Leland
Annmaria	Willy
Trix	Bevan
Vivyan	Ethelbert
Sileas	Fidole
Tarra	Dud
Melanie	Joshia
Norah	Ermin
Cornelia	Em
Phebe	Herby
Mercedes	Ken
Pansy	Dal
Franny	Ariel
Salome	Jerry
Erika	Vaughn
Andee	Urbain
Petronilla	Buddie
Alis	Redd
Carolyn	Marlin
Trude	Elvis
Coraline	Dalton
Dari	Delmor
Legra	Cash
Amelita	Olav
Ann	Jordan
Darelle	Allyn
Enrica	Shell
Sonia	Raimund
Raeann	Quint
Ceciley	Darius
Vanny	Shawn
Merilee	Roderich
Peria	Jaye
Amie	Thorvald
Regina	Humfried
Joey	Tiler
Alyssa	Burch
Lind	Fremont
Cherilyn	Ulrick
Carey	Scotti
Thekla	Renaud
Dyna	Wilhelm
Novelia	Cesaro
Mellisa	Galvin
Katya	Sergent
Crin	Biron
Dody	Saunders
Marion	Nikolaus
Glen	Rube
Tamar	Christophe
Christine	Ernesto
Faustina	Inness
Livvy	Der
Kerrie	Ivan
Nichole	Lockwood
Junie	Ugo
Fedora	Waring
Christyna	Renaud
Sarina	Codi
Noemi	Heinrik
Fanni	Reilly
Ranee	Malchy
Penny	Forrester
Kirby	Rob
Cherilynn	Aloysius
Isis	Urbain
Holly-Anne	Culver
Jonie	Vinson
Edith	Ulrick
Hettie	Chen
Maryrose	Jameson
Tandie	Carr
Jeana	Noah
Melisande	Frasquito
Constancia	Nelson
Merci	Gaile
Josefa	Jason
Corette	Cameron
Kakalina	Brandyn
Kendre	Godard
Winona	Paolo
Aprilette	Marlow
Eulalie	Trey
Corry	Noble
Berty	Temp
Drona	See
Aggie	Glendon
Gizela	Wash
Cristi	Rosco
Eachelle	Felic
Ronna	Britt
Tiertza	Evelin
Daveen	Felizio
Terese	Cullen
Harriot	Keelby
Benedicta	Feodor
Heida	Gray
Wally	Sauveur
Anni	Noak
Cherida	Rogers
Jeannette	Chico
Gloriane	Gregoor
Laetitia	Raddie
Margeaux	Penrod
Jacquie	Basil
Daryl	Hilly
Marketa	Dalt
Sibby	Jan
Martica	Matthieu
Florina	Dav
Steffi	Calv
Lelah	Nikos
Heloise	Huntington
Dana	Base
Willa	Felike
Dyana	Jean
Dacey	Reinhold
Elka	Elias
Sharyl	Hillier
Fianna	Randie
Deane	Ole
Collie	Ahmed
Julieta	Hermie
Jaquelin	Byrle
Sidonia	Boothe
Anatola	Ruben
Adrian	Bastian
Marijo	Tim
Milena	Quintin
Deirdre	Waylen
Thomasin	Sol
Norina	Nicolai
Jenine	Royall
Juditha	Guillermo
Amity	Theodore
Lavinia	Siegfried
Essa	Murray
Ardath	Nevile
Zorana	Gerek
Jeniece	Garner
Carroll	Jody
Rena	Phip
Lorri	Isidro
Cami	Boy
Madelena	Barnabas
Adelaida	Maury
Randene	Baryram
Avis	Joe
Jaquenette	Yehudi
Lizzie	Olly
Rebekah	Rollins
Janifer	Giovanni
Bibby	Julio
Carlie	Reinwald
Dian	Francesco
Mureil	Ferd
Delila	Blane
Karole	Renault
Nikkie	Engelbert
Leona	Scotti
Page	Preston
Blinny	Tiler
Elnora	Noak
Cloe	Elias
Bee	Elvin
Valene	Eberhard
Mitzi	Mic
Fern	Howey
Reena	Jeromy
Klara	Penny
Gertie	Bone
Cristina	Bat
Marice	Urbanus
Kala	Louis
Binny	Barnabas
Sabra	Roland
Shirlee	Sampson
Tera	Donall
Barbi	Man
Arlina	Anatollo
Dyana	Rodrigo
Vinnie	Alfons
Dyana	Fran
Felipa	Fair
Carmelia	Renard
Katina	Artus
Stephi	Barty
Estrella	Clay
Janeen	Darill
Kessia	Stanwood
Letisha	Brig
Conny	Nichols
Shaylyn	Basile
Christy	Neils
Latia	Jim
Giselle	Linoel
Merola	Bearnard
Margery	Stavros
Dulcy	Ciro
Emelyne	Emmett
Minni	Liam
Rhianna	Any
Selinda	Garald
Shandee	Geri
Lisetta	Waldemar
Agnes	Franklyn
Martguerita	Cal
Annabela	Sawyer
Danice	Thibaud
Roxana	Alphonso
Natka	Renado
Trudie	Barri
Berta	Jud
Carlye	Arley
Loleta	Filmer
Janaye	Egbert
Loutitia	Christoph
Judith	Madison
Yelena	Branden
Dominique	Phineas
Rona	Taddeo
Ashia	Coleman
Marysa	Petr
Marrissa	Miles
Fredelia	Wainwright
Sidonnie	Sanderson
Iolande	Tab
Rozanne	Jonas
Janetta	Jon
Melamie	Berk
Candida	Joseph
Maddie	Vick
Tarra	Jarrett
Moyra	Jeremias
Carmina	Allan
Constance	Pebrook
Elinor	Cull
Melisse	Vinny
Gerta	Kevan
Pearla	Gale
Aidan	Weider
Mame	Tulley
Annabel	Jermaine
Nona	Trip
Dolorita	Cesare
Jemmy	Nikolai
Kanya	Redd
Luisa	Abbey
Loreen	Sanders
Naomi	Burnaby
Ki	Langston
Suzanna	Lenci
Adelind	Norry
Daryl	Percy
Mildrid	Welsh
Jennilee	Garret
Eimile	Mahmud
Aurore	Dario
Raven	Garry
Malorie	Gayle
Gleda	Friedrick
Marie-Ann	Ossie
Mareah	Christoffer
Catharina	Northrup
Mellisa	Francis
Adore	Claybourne
Karry	Ulrick
Missy	Richart
Portia	Sigmund
Ruthy	Monte
Stefanie	Ches
Loreen	Westley
Aimee	Broddy
Didi	Ettore
Fara	Dallon
Caroline	Andrey
Lesya	Tuckie
Kassi	Jens
Lebbie	Lem
Anastasie	Ted
Brianna	Sigismundo
Gratia	Cole
Devon	Den
Louisette	Antons
Clemence	Eward
Adriana	Federico
Coriss	Hendrick
Suzette	Conrade
Giuditta	Stearne
Blinnie	Christoffer
Jaynell	Fredrick
Eleonore	Reese
Kristal	Dexter
Stacie	Shep
Corabella	Tiebout
Margarete	Farlay
Griselda	Wang
Kyla	Sawyer
Antonella	Hansiain
Grace	Julius
Lynett	Read
Nerti	Nester
Belinda	Witty
Cyndy	Ahmed
Brandea	Alonzo
Pearle	Brad
Minni	Raffaello
Tandie	Barr
Alfy	Shem
Lila	Turner
Ceciley	Francklin
Nedda	Antone
Mufi	Kippie
Rhea	Darbee
Clementia	Shelton
Sheree	Ermanno
Marysa	Maurie
Kellsie	Tobe
Shauna	Goddart
Doralia	Ollie
Marcela	Elias
Truda	Ragnar
Rosemary	Earlie
Alanna	Saundra
Dannye	Reamonn
Filide	Ginger
Cordie	Giffy
Benny	Carce
Gabrielle	Pyotr
Zarah	Onfre
Doroteya	Andrej
Mia	Bendicty
Astra	Alick
Pet	Luther
Camala	Fletcher
Lea	Tiebout
Joanie	Rufe
Marilin	Jarret
Ginni	Karlik
Leonanie	Felicio
Gerri	Hendrick
Guinevere	Joseph
Alecia	Christoph
Layney	Jody
Elbertina	Thatcher
Nert	Anson
Kizzie	Gerhardt
Rafaelita	Hermy
Marnia	Ethan
Katrina	Gregorius
Addie	Andras
Barbey	Olivero
Vanya	Lane
Cher	Rod
Michaela	Currie
Cathrine	Dana
Margy	Shannon
Jannel	Cory
Malorie	Heindrick
Lena	Glenn
Gabi	Edwin
Cassi	Godart
Maye	Mathe
Iormina	Keane
Juliane	Martie
Berna	Marcelo
Violette	Tobie
Kip	Aylmer
Gaye	Georges
Becki	Dieter
Ofilia	Papageno
Dannie	Ogdon
Iris	Derrek
Gwenni	Cosmo
Janean	Clemmy
Jeanna	Roscoe
Berri	Fields
Lark	Kennan
Nanice	Augie
Gwenette	Reid
Happy	Marcello
Gabriell	York
Gladys	Tobe
Dorotea	Andris
Vallie	Renato
Dominga	Archibald
Whitney	Hillary
Tallia	Fabio
Marsiella	Janek
Betteann	Hew
Ivett	Keenan
Norry	Paige
Tallie	Wendell
Bellanca	Vasily
Simonette	Pedro
Grata	Vaclav
Carine	Joel
Dulcinea	Kinnie
Teena	Reinaldo
Shay	Frans
Fallon	Casper
Berry	Randy
Sharai	Gaston
Pamela	Jeffrey
Cairistiona	Jaime
Catherina	Washington
Cass	Isidore
Cherey	Dietrich
Ethelyn	Corney
Collete	Erskine
Etty	Ruby
Rasla	Donaugh
Marley	Sutherland
Jade	Artie
Lil	Penn
Christiane	Gunter
Nissa	Tull
Rafaelita	Vaclav
Thomasine	Dino
Tallie	Massimo
Patti	Hakim
Louisette	Niel
Carmine	Gris
Tamera	Ludvig
Jasmina	Peter
Pauline	Kristos
Sephira	Geoffry
Darelle	Eadmund
Anita	Sloane
Liz	Shalom
Dione	Rodolphe
Jemmy	Gibb
Lishe	Nolly
Florri	Rurik
Johanna	Law
Karena	Sloan
Janenna	Benton
Neala	Tab
Tabbie	Harwilll
Demeter	Clayson
Arlee	Torrance
Joby	Garald
Caty	Tymothy
Devin	Keen
Sapphira	Ailbert
Marilyn	Ulrich
Marie	Ware
Lorena	Brok
Genevieve	Josiah
Ranice	Horacio
Linnea	Barris
Sean	Wit
Gladys	Kingsly
Alia	Vasili
Carmencita	Frants
Beverlie	Hy
Delora	Kaspar
Maris	Olly
Lynelle	Syd
Calli	Bartholomeus
Alyda	Sergei
Pam	Pren
Joelynn	Ezri
Georgette	Hi
Hannah	Lane
Lilllie	Jarred
Doretta	Jo
Minna	Ethelred
Dionne	Felicio
Sidonnie	Ilaire
Karlotte	Israel
Darryl	Ozzy
Tansy	Sargent
Martelle	Garald
Jana	Hansiain
Adele	Avram
Callida	Oates
Agnese	Eliot
Agna	Bary
Bernete	Jamison
Erina	Padriac
Fae	Ash
Alysia	Konrad
Krystyna	Norby
Claudia	Freemon
Eolande	Cassie
Kellie	Edan
Chrysler	Massimo
Simone	Kermie
Alexina	Aluin
Kellia	Heywood
Dalia	Bartie
Melisandra	Kendal
Andi	Leslie
Nicoline	Dolf
Easter	Berny
Gusty	Leonerd
Jennee	Port
Devon	Mikael
Vikki	Erek
Leonore	Gaylord
Cordey	Warner
Marja	Isacco
Jorey	Homerus
Jaquelyn	Kain
Savina	Roddy
Antonetta	Jesus
Jewel	Eddy
Teddi	Lane
Ertha	Darby
Rozamond	Jerome
Susanna	Byram
Maressa	Palm
Justine	Hermie
Carley	Max
Annmarie	Preston
Anne-Marie	Ronny
Hedy	Clemens
Estele	Griffie
Yalonda	Keenan
Hyacinthia	Darill
Dina	Leicester
Norean	Gothart
Gladi	Dannie
Natka	Richardo
Trudey	Inglebert
Millisent	Shadow
Tania	Leonerd
Carmen	Merry
Betteann	Elijah
Christin	Eb
Kittie	Elias
Maitilde	Basilio
Shawn	Reed
Linn	Sawyer
Charline	Remus
Ashlen	Renaud
Philis	Stevie
Guillemette	Farrell
Alane	Aldin
Lena	Hilton
Chelsey	Nikolaus
Evelyn	Gareth
Alie	Calvin
Julina	Jae
Charlotta	Vasilis
Vania	Stanislas
Avrit	Michail
Yolane	Stevy
Philippe	Demetri
Carlie	Ernst
Nina	Base
Cahra	Ansel
Joeann	Gabriel
Nicol	Anson
Jessie	Jeth
Arlana	Carolus
Sissie	Fonzie
Erna	Mervin
Julie	Caesar
Adelina	Richmond
Mirna	Trace
Claresta	Bary
Ailyn	Drew
Dorotea	Holden
Adrea	Benyamin
Rasia	Mark
Kora	Murdoch
Roch	Yule
Valma	Luke
Nariko	Paolo
Othilie	Thane
Sabrina	Olenolin
Maureene	Duke
Melodee	Scotty
Carolina	Fidel
Mirilla	Deane
Jeanne	Abram
Rochell	Isaac
Rayna	Eldridge
Reeva	Lowell
Rosalie	Gabi
Therese	Winthrop
Maryann	Lloyd
Feodora	Paco
Rori	Tracie
Jaclyn	Eddy
Cicily	Gabe
Lolita	Mahmoud
Gussie	Sherwin
Kalie	Silvain
Honor	Tully
Sula	Dwayne
Kathlin	Gordie
Zuzana	Daven
Margi	Wake
Jonie	Hill
Dionis	Phillip
Lotty	Dionisio
Tate	Sigfried
Shelley	Grant
Merl	Art
Clarabelle	Archambault
Renate	Rockie
Kayle	Thaxter
Neda	Raffaello
Laryssa	Gradey
Agnes	Denys
Orly	Hogan
Giulietta	Augustine
Breena	Chevalier
Demetria	Skip
Bree	Mata
Sheree	Jasen
Marnia	Maddie
Jyoti	Jeremias
Charis	Pattie
Shel	Maynard
Renelle	Baxter
Tonya	Kaiser
Rena	Dugald
Karalynn	Davy
Antonietta	Zane
Nadiya	Frazier
Bonny	Tracy
Robinia	Selig
Natalya	Nicolis
Emilie	Tait
Sella	Jone
Rachele	Tyrone
Pris	Sargent
Ginnifer	Randolf
Annnora	Will
Gwennie	Haley
Cecilla	Rooney
Marji	Dallas
Erinn	Raleigh
Kordula	Kinsley
Celle	Haily
Jolie	Jacob
Carolina	Caryl
Wenona	Creight
Kori	Cobby
Haley	Julie
Tamera	Raffaello
Corinne	Walther
Joline	Benoit
Dulce	Gar
Anthiathia	Seamus
Anne-Corinne	Allayne
Ianthe	Mohandas
Sonya	Berton
Ailene	Guss
Dianne	Mitchell
Sande	Emmerich
Rosette	Theo
Shandeigh	Eldon
Jandy	Leonhard
Caryn	Giovanni
Lindsy	Dudley
Elfrida	Arel
Elena	Abba
Tandie	Rancell
Tammie	Jerome
Erika	Morly
Charleen	Rurik
Noemi	Gayle
Juditha	Duane
Callie	Andras
Waly	Skye
Norry	Peadar
Petrina	Stearn
Alyse	Welbie
Gertruda	Kristoffer
Leeanne	Halsey
Justine	Eduino
Jobie	Hammad
Robby	Nate
Starla	Seumas
Mureil	Brice
Eileen	Ernestus
Vitoria	Cheston
Brynna	Miltie
Viola	Salim
Laraine	Redd
Caterina	Obediah
Koo	Orlan
Sherri	Val
Yvette	Howard
Maurita	Ferris
Ora	Vidovic
Ora	Duffie
Ulrikaumeko	Henri
Fernande	Keelby
Cori	Dominique
Jerry	Urbain
Marney	Xymenes
Lusa	Rodd
Theodosia	Gaven
Clementia	Somerset
Alejandrina	Hugh
Bernardina	Jeremie
Cathlene	Neville
Laura	Darill
Della	Marcos
Gael	Rice
Debora	Silas
Trudey	Rustin
Charlotta	Ibrahim
Gerri	Dewie
Liv	Rafferty
Star	Laughton
Selina	Darius
Vicki	Marcellus
Bobbi	Derwin
Opal	Devin
Veronica	Olly
Johanna	Jerald
Regan	Algernon
Stephani	Errol
Rosmunda	Garrek
Raeann	Winn
Erminia	Lucais
Korry	Stuart
Pierette	Aubert
Agneta	Norman
Aura	Thatcher
Lelah	Neel
Vilma	Dew
Charlotta	Chaunce
Misti	Reade
Lindsy	Darrel
Leonelle	Glenden
Jaquelin	Dag
Tera	Asa
Lelia	Culver
Brittany	Niall
Robbyn	Linn
Danila	Udall
Lucila	Herb
Eloise	Vassily
Gertrudis	Isidoro
Selle	Gayler
Kacey	Carlo
Cosette	Ahmed
Pamela	Patty
Gayleen	Thoma
Dedie	Donn
Lucy	Brucie
Aeriela	Morris
Carlee	Fred
Tricia	Kennett
Felice	Kelsey
Karie	Claiborne
Ki	Matthaeus
Aleda	Edsel
Suzy	Onofredo
Beatrisa	Morgan
Mirelle	Nathanael
Adelice	Dur
Shayla	Corty
Lynea	Lek
Sheri	Gasper
Myrilla	Whitney
Katuscha	Chip
Hildy	Meredith
Misti	Mordecai
Nicholle	Jerrie
Audra	Val
Truda	Matteo
Sybil	Broderic
Hephzibah	Mandel
Carly	Ichabod
Jacklin	Guglielmo
Marie-Jeanne	Alfons
Carol	Walther
Jenda	Lefty
Marley	Benjy
Shanie	Rollins
Xylia	Nathanial
Mavra	Gilles
Kassie	Cirilo
Gracie	Walther
Dacia	Roddy
Ina	Perry
Kimbra	Hubey
Barbette	Cliff
Georgette	Waldon
Koralle	Isidore
Ruthe	Stanley
Angy	Hamlen
Martica	Gregor
Opal	Arri
Jeri	Titos
Frieda	Myca
Mollee	Tad
Jewel	Gino
Jody	Hagen
Milly	Olivier
Afton	Maison
Willa	Norton
Tracey	Hubie
Catrina	Cecilius
Deane	Winslow
Cordula	Mikael
Toni	Padraic
Sandy	Mathe
Georgia	Rriocard
Quintana	Yancy
Alys	Byrle
Ophelie	Riobard
Amelita	Hillie
Johnna	Rey
Tami	Garrick
Gabbi	Virgilio
Jehanna	Vito
Amberly	Jessey
Charlot	Gaylor
Carmella	Philbert
Adiana	Dalt
Consolata	Fairfax
Lora	Ram
Amity	Heall
Dianna	Ewen
Dolores	Tomkin
Dorice	August
Cory	Alexandre
Aimil	Bryn
Suzi	Tomaso
Bab	Conrade
Ollie	Yves
Melania	Jamison
Tabbi	Thacher
Xylia	Ruben
Shirleen	Stafford
Carlyn	Em
Margarethe	Sandy
Melisse	Garik
Vittoria	Ingrim
Jeana	Eward
Klara	Harp
Halley	Gothart
Yoko	Harper
Sascha	Spike
Waneta	Jehu
Mandi	Desmund
Grethel	Ryan
Leshia	Sergio
Mag	Allan
Florie	Dannie
Debbi	Benedicto
Norrie	Tobie
Robinette	Allie
Margeaux	Cornelius
Sarita	Wye
Myrle	Miller
Pearl	Raynard
Glen	Ruy
Darbie	Cornie
Maryellen	Dilly
Martguerita	Brewster
Tabina	Costa
Tamarra	Jere
Hedi	Rancell
Bessy	Benjamin
Tedda	Roberto
Maddalena	Sherman
Lura	Carlie
Emmalynn	Conan
Eddy	Tann
Costanza	Chaunce
Ileana	Garey
Lethia	Mylo
Ellene	Terrel
Faythe	Loren
Sarina	Othello
Eveline	Rex
Christy	Ruggiero
Adelle	Nealson
Rosy	Iorgos
Farand	Ches
Maxy	Rawley
Tuesday	Joe
Karlotta	Aldwin
Tatiana	Loydie
Domini	Reginauld
Oralle	Rolland
Danica	Olav
Simonette	Romeo
Briny	Bryon
Nadya	Angelico
Vinni	Penny
Lucinda	Salomo
Adrianna	Nicolis
Barbi	Sterne
Juditha	Gayler
Elena	Vladamir
Allison	Dennie
Kaylil	Robin
Concettina	Kienan
Shir	Ambrosius
Henrie	Elvis
Fifine	Claudio
Izabel	Patton
Eudora	Bren
Erda	Gardener
Nicole	Derwin
Leland	Blair
Hesther	Franky
Mabelle	Eduard
Dorrie	Kimbell
Phillie	Niccolo
Lenette	Richie
Doria	Lincoln
Brandea	Wally
Dayna	Marcus
Elene	Johnnie
Kania	Lucian
Maryjo	Tomlin
Sibel	Chaunce
Pearline	Eward
Roana	Rock
Marissa	Trefor
Christal	Lalo
Briana	Tirrell
Anselma	Brig
Cyb	Rossie
Penelopa	Marwin
Lexie	Emmett
Paola	Aldus
Sheila	Cletis
Cicily	Otho
Lavinia	Orin
Binnie	Virgilio
Tandi	Boone
Teodora	Eliot
Rea	Free
Fanchette	Damien
Alyssa	Raymund
Marlena	Rock
Kamila	Urban
Sharl	Gannie
Norma	Bailey
Rozalin	Gideon
Theresina	Stern
Karissa	Gawain
Stormie	Kristoffer
Shane	Neale
Britte	Teddy
Camille	Osborne
Halette	Stearn
Emiline	Luigi
Patty	Ev
Nerty	Sylas
Euphemia	Fran
Karmen	Judon
Hayley	Curtice
Aundrea	Marve
Shandra	Quinton
Kath	Cecilio
Celisse	Granthem
Emylee	Peder
Addia	Ron
Saraann	Yul
Lucie	Hobie
Liv	Obed
Idaline	Barny
Cristionna	Gerhardt
Rica	Ennis
Corey	Nobie
Rozalin	Bevon
Lil	Dennet
Hannah	Waverly
Carly	Torre
Ethelda	Anatol
Serene	Ezechiel
Sam	Domenic
Devi	Whitney
Dorella	Devin
Rubetta	Baldwin
Jo-Ann	Yorker
Roxana	Rollie
Sherye	Andreas
Madelin	Stanwood
Emera	Dalt
Horatia	Roma
Danielle	Harv
Sandye	Sayres
Babbie	Everett
Camel	Richart
Florrie	Dewitt
Karoline	Edlin
Roxie	Fabiano
Vanessa	Mauricio
Annetta	Roddy
Cathe	Link
Suzette	Felice
Sissy	Rouvin
Caty	Bert
Rubi	Jamaal
Kaitlyn	Cleon
Alverta	Alasdair
Denise	Beauregard
Adara	Iain
Beverly	Ezra
Sukey	Bealle
Jemie	Graham
Tammara	Zed
Lurline	Archibaldo
Joanne	Erhard
Bessy	Marlow
Hetti	Ezequiel
Marta	Urban
Vonnie	Gunar
Goldi	Kilian
Trescha	Franklyn
Hyacinth	Tynan
Eleonora	Leonard
Anabelle	Bertram
Rhodia	Norbie
Violet	Dante
Goldina	Adler
Grissel	Moritz
Michel	Jedediah
Fleur	Amby
Carolynn	Arin
Kimmi	Dex
Laryssa	Llywellyn
Joceline	Abe
Shawna	Tedmund
Marcelline	Tabby
Michele	Shay
Caprice	Theodoric
Cecil	Matty
Fannie	Nevins
Moina	Perice
Torey	Gray
Aleece	Quintus
Gabriel	Jodie
Clarice	Chandler
Emily	Timoteo
Farrand	Ron
Vally	Darb
Allyn	Lazare
Gwendolyn	Filbert
Aubrette	Baily
Shara	Pincus
Veronike	Neville
Taffy	Kingston
Susette	Lovell
Tomasina	Skipp
Tabbie	Mel
Harrietta	Lorry
Arleen	Markus
Jane	Otis
Janet	Hansiain
Beatriz	Derward
Fallon	Stanislaw
Georgette	Fabien
Elfrieda	Trstram
Jenna	Turner
Maible	Kit
Gilli	Desmund
Libbi	Yul
Star	Joaquin
Vivia	Kaiser
Riki	Kalil
Janet	Bernie
Audra	Hart
Kinna	Brendan
Kristan	Fielding
Carmine	Kelvin
Hedwig	Niall
Jacintha	Alejandro
Antonina	Jaymie
Belvia	Ruprecht
Shalne	Thebault
Rosaline	Karlis
Emily	Morie
Brunhilde	Sidnee
Hedda	Hugo
Timothea	Reinhard
Bird	Freedman
Florina	Langsdon
Bertie	Jordan
Bell	Blake
Othella	Toby
Goldina	Davon
Phyllida	Chan
Rebeka	Man
Rhonda	Layton
Sonnie	Lyman
Daile	Gill
Gloriana	Cary
Adara	Chase
Justina	Roma
Penelope	Brody
Nicolina	Aldridge
Elle	Arther
Adella	Neville
Cinderella	Goddard
Claudine	Parsifal
Eloisa	Stanfield
Tory	Kerwinn
Mil	Vaughan
Verine	Vince
Cecile	Mychal
Fanya	Ugo
Minerva	Aluino
Catarina	Elwyn
Nanine	Bucky
Esmaria	Rudd
Kassia	Trstram
Bethena	Abel
Almeda	Leroi
Adriane	Ashbey
Jennilee	Mitchel
Karmen	Sylvan
Eleonore	Dante
Ginny	Chen
Alleen	Lenci
Nikkie	Kermy
Robbyn	Lind
Charin	Maurizio
Carole	Kimble
Melissa	Lem
Mirabella	Walt
Kerrill	Renato
Ysabel	Erastus
Malanie	Chaddy
Joyan	Linn
Codie	Bryn
Joann	Terrence
Pippy	Worth
Cissiee	Ingrim
Ariadne	Mill
Loutitia	Damon
Jacinda	Donnell
Eleni	Wallace
Antonietta	Niles
Corliss	Hastings
Vita	Gualterio
Alisa	Augustine
Doroteya	Wait
Gwenore	Neale
Elna	Brice
Angil	Devlen
Milissent	Vinson
Imogene	Obadias
Junie	Cirillo
Viola	Dallas
Lilias	Giffie
Elga	Michale
Sula	Skelly
Helga	Vasilis
Gypsy	Cassius
Mable	Seward
Deva	Marchall
Penelope	Pren
Kacey	Blane
Binnie	Freddy
Mattie	Hewe
Maegan	Bucky
Shirl	Donn
Milissent	Gabi
Meryl	Rancell
Marcelline	Derril
Gavrielle	Lucius
Albina	Ethelred
Correy	Leonardo
Tessi	Rem
Chicky	Win
Wilmette	Normie
Evonne	Hilary
Dena	Linus
Madeline	Andrej
Jorey	Frankie
Ursola	Der
Kerrie	Merv
Vonni	Reggis
Erica	Maximilien
Bebe	Eduino
Terry	Weston
Claudie	Reidar
Moria	Thedric
Oralee	Lin
Carmine	Thayne
Ondrea	Shem
Sharai	Iggy
Katinka	Sebastian
Melisenda	Major
Kelly	Lindon
Una	Jimmie
Collen	Fee
Arleyne	Briggs
Pet	Tiebout
Grissel	Errol
Nicol	Kalvin
